TotalIncomingRequests,EOFErrors,ECONNREFUSEDErrors,TrueECONNRESETErrors,TotalOutgoingRequests,OutgoingNetworkErrors,Hostname,SuccessfulOutgoingRequests,FailedOutgoingRequests,OutgoingUnknownErrors,OutgoingHTTPErrors,ForceClosedErrors,ECONNABORTEDErrors
363,0,0,0,378544,0,go-server-deployment-56dd4c9fc7-xkrtk,378544,0,0,0,0,0
238650,0,0,0,430153,0,go-server-deployment-84ddfbc887-fxhjt,430153,0,0,0,0,0
0,0,0,0,1033393,0,go-server-deployment-84ddfbc887-9b9zz,1033393,0,0,0,0,0
0,0,0,0,443911,0,go-server-deployment-84ddfbc887-ljkmd,443911,0,0,0,0,0
555903,0,1,0,313648,1,go-server-deployment-84ddfbc887-xkkd7,313647,1,0,0,0,0
999286,0,1,0,740755,2,go-server-deployment-84ddfbc887-l7xm4,740753,2,0,0,0,0
247975,0,1,0,93076,1,go-server-deployment-56dd4c9fc7-7tpc7,93075,1,0,0,0,0
1468,0,0,0,282077,0,go-server-deployment-84ddfbc887-mvshl,282077,0,0,0,0,0
81962,0,0,0,348395,0,go-server-deployment-84ddfbc887-wdn7p,348395,0,0,0,0,0
0,0,0,0,281668,0,go-server-deployment-56dd4c9fc7-r2484,281668,0,0,0,0,0
4988,0,0,0,561584,0,go-server-deployment-84ddfbc887-2n4jv,561584,0,0,0,0,0
0,0,3,0,1016527,3,go-server-deployment-84ddfbc887-5s8zr,1016524,3,0,0,0,0
397217,0,2,0,223009,2,go-server-deployment-84ddfbc887-kkdc4,223007,2,0,0,0,0
287649,0,0,0,242098,0,go-server-deployment-56dd4c9fc7-5dtkj,242098,0,0,0,0,0
2244303,0,2,0,510235,2,go-server-deployment-84ddfbc887-q2jw7,510233,2,0,0,0,0
570849,0,5,0,163192,5,go-server-deployment-56dd4c9fc7-hpmfv,163187,5,0,0,0,0
517014,0,1,0,184866,1,go-server-deployment-56dd4c9fc7-5znqp,184865,1,0,0,0,0
518203,0,1,0,224082,2,go-server-deployment-56dd4c9fc7-4m7gv,224080,2,0,0,0,0
0,0,0,0,128619,1,go-server-deployment-56dd4c9fc7-sc6r7,128618,1,0,0,0,0
2102544,0,20,0,477720,20,go-server-deployment-56dd4c9fc7-db9sc,477700,20,0,0,0,0
0,0,0,0,976594,0,go-server-deployment-84ddfbc887-67v47,976594,0,0,0,0,0
0,0,0,0,238703,0,go-server-deployment-84ddfbc887-2m9sc,238703,0,0,0,0,0
77320,0,0,0,549872,0,go-server-deployment-56dd4c9fc7-92wg2,549872,0,0,0,0,0
1497,0,0,0,354037,0,go-server-deployment-84ddfbc887-t6xxh,354037,0,0,0,0,0
963675,0,0,0,220177,0,go-server-deployment-84ddfbc887-9g6g8,220177,0,0,0,0,0
187562,0,0,0,377626,0,go-server-deployment-84ddfbc887-cxnf5,377626,0,0,0,0,0
182218,0,0,0,341277,0,go-server-deployment-56dd4c9fc7-q2st4,341277,0,0,0,0,0
203235,0,0,0,209284,0,go-server-deployment-56dd4c9fc7-7xqwz,209284,0,0,0,0,0
1083,0,0,0,417332,0,go-server-deployment-84ddfbc887-s4qfp,417332,0,0,0,0,0
361345,0,3,0,102642,3,go-server-deployment-56dd4c9fc7-p4ww6,102639,3,0,0,0,0
592853,0,14,0,726319,14,go-server-deployment-56dd4c9fc7-pp4ph,726305,14,0,0,0,0
3296421,0,1,0,669594,1,go-server-deployment-84ddfbc887-kns8h,669593,1,0,0,0,0
0,0,3,0,179367,3,go-server-deployment-84ddfbc887-v52k7,179364,3,0,0,0,0
0,0,0,0,531016,0,go-server-deployment-84ddfbc887-w5rx4,531016,0,0,0,0,0
1891951,0,1,0,861248,1,go-server-deployment-84ddfbc887-sdb87,861247,1,0,0,0,0
0,0,2,0,298101,2,go-server-deployment-84ddfbc887-qghpf,298099,2,0,0,0,0
0,0,0,0,749349,0,go-server-deployment-84ddfbc887-g7m5s,749349,0,0,0,0,0
302658,0,0,0,539054,0,go-server-deployment-84ddfbc887-ngsld,539054,0,0,0,0,0
778373,0,1,0,598189,1,go-server-deployment-84ddfbc887-6l4xm,598188,1,0,0,0,0
465273,0,0,0,326137,0,go-server-deployment-84ddfbc887-8767f,326137,0,0,0,0,0
0,0,0,0,222275,0,go-server-deployment-56dd4c9fc7-bz468,222275,0,0,0,0,0
0,0,0,0,535191,0,go-server-deployment-84ddfbc887-27llt,535191,0,0,0,0,0
2190564,0,0,0,314144,0,go-server-deployment-84ddfbc887-rzm6j,314144,0,0,0,0,0
0,0,0,0,231288,0,go-server-deployment-56dd4c9fc7-7z6gv,231288,0,0,0,0,0
0,0,1,0,353263,1,go-server-deployment-84ddfbc887-mlwkb,353262,1,0,0,0,0
503753,0,1,0,242272,1,go-server-deployment-84ddfbc887-64jgh,242271,1,0,0,0,0
0,0,0,0,834289,0,go-server-deployment-84ddfbc887-x7psj,834289,0,0,0,0,0
110670,0,0,0,206468,0,go-server-deployment-84ddfbc887-5s7lk,206468,0,0,0,0,0
0,0,0,0,815174,0,go-server-deployment-84ddfbc887-jm5f8,815174,0,0,0,0,0
0,0,0,0,529234,0,go-server-deployment-84ddfbc887-wvhgz,529234,0,0,0,0,0
0,0,0,0,445145,0,go-server-deployment-84ddfbc887-mg6z7,445145,0,0,0,0,0
90909,0,0,0,398856,0,go-server-deployment-84ddfbc887-pgb2v,398856,0,0,0,0,0
0,0,1,0,484468,1,go-server-deployment-56dd4c9fc7-9hddx,484467,1,0,0,0,0
271985,0,9,0,178587,9,go-server-deployment-56dd4c9fc7-sk4gp,178578,9,0,0,0,0
284515,0,5,0,672485,5,go-server-deployment-56dd4c9fc7-jfdwd,672480,5,0,0,0,0
619684,0,1,0,213736,1,go-server-deployment-84ddfbc887-ztsw9,213735,1,0,0,0,0
0,0,1,0,336477,1,go-server-deployment-56dd4c9fc7-mnwhl,336476,1,0,0,0,0
0,0,1,0,808073,1,go-server-deployment-84ddfbc887-lbpk7,808072,1,0,0,0,0
0,0,0,0,250639,0,go-server-deployment-56dd4c9fc7-cjvdd,250639,0,0,0,0,0
0,0,2,0,276306,2,go-server-deployment-84ddfbc887-97776,276304,2,0,0,0,0
1560962,0,4,0,129463,4,go-server-deployment-56dd4c9fc7-srwpl,129459,4,0,0,0,0
0,0,0,0,364056,0,go-server-deployment-84ddfbc887-88f9t,364056,0,0,0,0,0
184108,0,2,0,403607,2,go-server-deployment-84ddfbc887-8s96z,403605,2,0,0,0,0
0,0,0,0,163173,0,go-server-deployment-56dd4c9fc7-bk8cm,163173,0,0,0,0,0
361160,0,0,0,188805,0,go-server-deployment-84ddfbc887-rnh78,188805,0,0,0,0,0
341380,0,2,0,453813,2,go-server-deployment-56dd4c9fc7-8jvbs,453811,2,0,0,0,0
1428187,0,0,0,243624,0,go-server-deployment-84ddfbc887-gnfd4,243624,0,0,0,0,0
1200064,0,3,0,777677,3,go-server-deployment-56dd4c9fc7-qmvnf,777674,3,0,0,0,0
1274320,0,1,0,74454,1,go-server-deployment-56dd4c9fc7-gwql8,74453,1,0,0,0,0
691519,0,0,0,393632,0,go-server-deployment-56dd4c9fc7-vqt9v,393632,0,0,0,0,0
19722,0,0,0,185558,0,go-server-deployment-56dd4c9fc7-btxgx,185558,0,0,0,0,0
1846578,0,7,0,497532,7,go-server-deployment-56dd4c9fc7-cz6tf,497525,7,0,0,0,0
689833,0,0,0,329325,0,go-server-deployment-84ddfbc887-n2h4h,329325,0,0,0,0,0
649028,0,1,0,618403,1,go-server-deployment-84ddfbc887-nn9b2,618402,1,0,0,0,0
593022,0,0,0,481312,0,go-server-deployment-56dd4c9fc7-j5v5w,481312,0,0,0,0,0
1564691,0,4,0,680794,4,go-server-deployment-84ddfbc887-tf7gb,680790,4,0,0,0,0
1369527,0,0,0,1104910,0,go-server-deployment-84ddfbc887-7tk5p,1104910,0,0,0,0,0
26995,0,1,0,242710,1,go-server-deployment-84ddfbc887-dwkfs,242709,1,0,0,0,0
0,0,0,0,567967,0,go-server-deployment-84ddfbc887-szrdf,567967,0,0,0,0,0
127118,0,0,0,159196,0,go-server-deployment-56dd4c9fc7-sz66j,159196,0,0,0,0,0
389881,0,1,0,329221,1,go-server-deployment-56dd4c9fc7-4xwcm,329220,1,0,0,0,0
6288,0,1,0,424609,1,go-server-deployment-84ddfbc887-vjxxr,424608,1,0,0,0,0
719691,0,2,0,165622,2,go-server-deployment-84ddfbc887-qldkh,165620,2,0,0,0,0
355554,0,1,0,162832,1,go-server-deployment-56dd4c9fc7-g6482,162831,1,0,0,0,0
0,0,0,0,793799,0,go-server-deployment-84ddfbc887-rxqmn,793799,0,0,0,0,0
0,0,0,0,1122029,0,go-server-deployment-84ddfbc887-2k2hg,1122029,0,0,0,0,0
1575833,0,3,0,494414,3,go-server-deployment-84ddfbc887-pwxn5,494411,3,0,0,0,0
0,0,1,0,302918,1,go-server-deployment-56dd4c9fc7-pllns,302917,1,0,0,0,0
0,0,0,0,420890,0,go-server-deployment-56dd4c9fc7-xjj8q,420890,0,0,0,0,0
845278,0,0,0,781285,0,go-server-deployment-84ddfbc887-xbr8f,781285,0,0,0,0,0
34151,0,1,0,417916,1,go-server-deployment-56dd4c9fc7-fxjw4,417915,1,0,0,0,0
234931,0,3,0,247886,3,go-server-deployment-56dd4c9fc7-5cpg9,247883,3,0,0,0,0
851926,0,1,0,230400,1,go-server-deployment-84ddfbc887-m9d5n,230399,1,0,0,0,0
126239,0,0,0,475005,0,go-server-deployment-56dd4c9fc7-9z86g,475005,0,0,0,0,0
692472,0,0,0,332679,0,go-server-deployment-84ddfbc887-94wvz,332679,0,0,0,0,0
0,0,0,0,530827,0,go-server-deployment-84ddfbc887-252tq,530827,0,0,0,0,0
0,0,0,0,258967,0,go-server-deployment-84ddfbc887-kgdln,258967,0,0,0,0,0
0,0,0,0,641387,0,go-server-deployment-84ddfbc887-x82m9,641387,0,0,0,0,0
221377,0,9,0,270206,9,go-server-deployment-56dd4c9fc7-nt8ns,270197,9,0,0,0,0
6907,0,0,0,395742,0,go-server-deployment-84ddfbc887-gbq6c,395742,0,0,0,0,0
5699,0,6,0,363504,7,go-server-deployment-56dd4c9fc7-lbwzf,363497,7,0,0,0,0
0,0,3,0,585200,3,go-server-deployment-84ddfbc887-z6vbq,585197,3,0,0,0,0
1031513,0,2,0,763475,2,go-server-deployment-84ddfbc887-s4f97,763473,2,0,0,0,0
400398,0,1,0,293569,1,go-server-deployment-56dd4c9fc7-wtcvc,293568,1,0,0,0,0
398097,0,3,0,378731,3,go-server-deployment-56dd4c9fc7-qxwkj,378728,3,0,0,0,0
772343,0,1,0,318349,1,go-server-deployment-84ddfbc887-xrkbk,318348,1,0,0,0,0
1906436,0,2,0,817163,2,go-server-deployment-84ddfbc887-4t4j7,817161,2,0,0,0,0
2673,0,1,0,565541,1,go-server-deployment-84ddfbc887-cvbkt,565540,1,0,0,0,0
941334,0,1,0,712422,1,go-server-deployment-84ddfbc887-7f4jr,712421,1,0,0,0,0
552619,0,0,0,339988,0,go-server-deployment-84ddfbc887-dz69x,339988,0,0,0,0,0
605053,0,1,0,414599,1,go-server-deployment-56dd4c9fc7-46ms8,414598,1,0,0,0,0
231452,0,1,0,213972,1,go-server-deployment-56dd4c9fc7-wkj7w,213971,1,0,0,0,0
270258,0,0,0,306416,0,go-server-deployment-84ddfbc887-2kbzf,306416,0,0,0,0,0
1152260,0,5,0,1039221,5,go-server-deployment-84ddfbc887-xwklj,1039216,5,0,0,0,0
0,0,0,0,555115,0,go-server-deployment-56dd4c9fc7-td64f,555115,0,0,0,0,0
0,0,0,0,526252,0,go-server-deployment-84ddfbc887-4q6rq,526252,0,0,0,0,0
530400,0,4,0,128914,4,go-server-deployment-56dd4c9fc7-9bq6z,128910,4,0,0,0,0
809626,0,1,0,174283,1,go-server-deployment-56dd4c9fc7-m5hpw,174282,1,0,0,0,0
0,0,0,0,191858,0,go-server-deployment-56dd4c9fc7-llbb5,191858,0,0,0,0,0
21610,0,4,0,493577,4,go-server-deployment-56dd4c9fc7-crzjl,493573,4,0,0,0,0
442133,0,0,0,646891,0,go-server-deployment-56dd4c9fc7-xdggr,646891,0,0,0,0,0
84754,0,0,0,268966,0,go-server-deployment-56dd4c9fc7-2669m,268966,0,0,0,0,0
563136,0,13,0,547500,13,go-server-deployment-56dd4c9fc7-xn55l,547487,13,0,0,0,0
429896,0,0,0,247263,0,go-server-deployment-56dd4c9fc7-ccf64,247263,0,0,0,0,0
391118,0,1,0,135718,1,go-server-deployment-56dd4c9fc7-b82w7,135717,1,0,0,0,0
675372,0,0,0,242624,0,go-server-deployment-84ddfbc887-99bp2,242624,0,0,0,0,0
0,0,0,0,154842,0,go-server-deployment-56dd4c9fc7-xm6nq,154842,0,0,0,0,0
305856,0,2,0,160677,2,go-server-deployment-56dd4c9fc7-hfvlv,160675,2,0,0,0,0
547284,0,14,0,112532,14,go-server-deployment-56dd4c9fc7-sk22r,112518,14,0,0,0,0
247835,0,0,0,184566,0,go-server-deployment-56dd4c9fc7-pw8db,184566,0,0,0,0,0
473310,0,4,0,198333,4,go-server-deployment-84ddfbc887-r2xxb,198329,4,0,0,0,0
0,0,0,0,94179,0,go-server-deployment-56dd4c9fc7-zbxkb,94179,0,0,0,0,0
613807,0,0,0,221443,0,go-server-deployment-84ddfbc887-pnpx6,221443,0,0,0,0,0
1209874,0,4,0,547718,4,go-server-deployment-56dd4c9fc7-hl8nb,547714,4,0,0,0,0
0,0,3,0,307075,3,go-server-deployment-56dd4c9fc7-967bj,307072,3,0,0,0,0
123563,0,4,0,606633,4,go-server-deployment-84ddfbc887-5ttr9,606629,4,0,0,0,0
0,0,4,0,276651,4,go-server-deployment-56dd4c9fc7-xxwsm,276647,4,0,0,0,0
0,0,0,0,762523,0,go-server-deployment-84ddfbc887-5d2td,762523,0,0,0,0,0
1112361,0,0,0,387185,0,go-server-deployment-84ddfbc887-b75pw,387185,0,0,0,0,0
482744,0,0,0,297528,0,go-server-deployment-56dd4c9fc7-7g8pg,297528,0,0,0,0,0
338199,0,0,0,178223,0,go-server-deployment-84ddfbc887-b5h49,178223,0,0,0,0,0
0,0,4,0,263364,4,go-server-deployment-56dd4c9fc7-s9cgv,263360,4,0,0,0,0
0,0,0,0,198638,0,go-server-deployment-56dd4c9fc7-srws4,198638,0,0,0,0,0
331642,0,1,0,225278,1,go-server-deployment-56dd4c9fc7-tj4dj,225277,1,0,0,0,0
98341,0,0,0,539671,0,go-server-deployment-84ddfbc887-6szsj,539671,0,0,0,0,0
0,0,1,0,884644,1,go-server-deployment-84ddfbc887-l4945,884643,1,0,0,0,0
0,0,0,0,431398,0,go-server-deployment-56dd4c9fc7-6rsxz,431398,0,0,0,0,0
1366877,0,8,0,130709,8,go-server-deployment-56dd4c9fc7-2xpwl,130701,8,0,0,0,0
0,0,0,0,875435,0,go-server-deployment-84ddfbc887-kv7qt,875435,0,0,0,0,0
31675,0,3,0,267902,4,go-server-deployment-56dd4c9fc7-g89gd,267898,4,0,0,0,0
0,0,1,0,451153,1,go-server-deployment-56dd4c9fc7-p2bjt,451152,1,0,0,0,0
43,0,0,0,549965,0,go-server-deployment-84ddfbc887-bp8f9,549965,0,0,0,0,0
585333,0,3,0,1097101,3,go-server-deployment-84ddfbc887-7jfn7,1097098,3,0,0,0,0
0,0,0,0,291380,0,go-server-deployment-56dd4c9fc7-q9vzf,291380,0,0,0,0,0
0,0,1,0,308589,1,go-server-deployment-56dd4c9fc7-7d86g,308588,1,0,0,0,0
643262,0,1,0,473379,1,go-server-deployment-84ddfbc887-zwn4r,473378,1,0,0,0,0
241575,0,0,0,166337,0,go-server-deployment-56dd4c9fc7-2cpwc,166337,0,0,0,0,0
0,0,3,0,758175,3,go-server-deployment-56dd4c9fc7-nlbfm,758172,3,0,0,0,0
4368,0,0,0,506991,0,go-server-deployment-56dd4c9fc7-4lr2m,506991,0,0,0,0,0
0,0,1,0,255586,2,go-server-deployment-56dd4c9fc7-xlb7b,255584,2,0,0,0,0
2292226,0,13,0,237208,13,go-server-deployment-56dd4c9fc7-v57wh,237195,13,0,0,0,0
1123563,0,4,0,177996,4,go-server-deployment-56dd4c9fc7-kgr7t,177992,4,0,0,0,0
792520,0,2,0,528240,2,go-server-deployment-56dd4c9fc7-jvljd,528238,2,0,0,0,0
260349,0,4,0,243751,4,go-server-deployment-56dd4c9fc7-zjhqz,243747,4,0,0,0,0
257479,0,0,0,245708,0,go-server-deployment-56dd4c9fc7-r7h22,245708,0,0,0,0,0
0,0,1,0,772334,1,go-server-deployment-84ddfbc887-bvbjq,772333,1,0,0,0,0
0,0,0,0,453871,0,go-server-deployment-56dd4c9fc7-dfprm,453871,0,0,0,0,0
317811,0,6,0,194891,6,go-server-deployment-56dd4c9fc7-ksp9w,194885,6,0,0,0,0
969431,0,0,0,279000,0,go-server-deployment-84ddfbc887-7s728,279000,0,0,0,0,0
82988,0,0,0,1244604,0,go-server-deployment-84ddfbc887-zzw8s,1244604,0,0,0,0,0
0,0,0,0,654481,0,go-server-deployment-56dd4c9fc7-8n2hd,654481,0,0,0,0,0
940708,0,4,0,330140,7,go-server-deployment-84ddfbc887-fkbmz,330133,7,0,0,0,0
895545,0,1,0,238375,1,go-server-deployment-84ddfbc887-x8rkb,238374,1,0,0,0,0
121850,0,1,0,237488,1,go-server-deployment-84ddfbc887-fw5h2,237487,1,0,0,0,0
0,0,0,0,249000,0,go-server-deployment-56dd4c9fc7-2wct6,249000,0,0,0,0,0
6417,0,0,0,682269,0,go-server-deployment-84ddfbc887-vltbv,682269,0,0,0,0,0
0,0,0,0,1079775,0,go-server-deployment-84ddfbc887-7bkfw,1079775,0,0,0,0,0
4131,0,0,0,109331,0,go-server-deployment-56dd4c9fc7-gxpgf,109331,0,0,0,0,0
792562,0,1,0,292905,1,go-server-deployment-84ddfbc887-5mq42,292904,1,0,0,0,0
0,0,0,0,631844,0,go-server-deployment-56dd4c9fc7-52sqz,631844,0,0,0,0,0
1791595,0,2,0,520075,2,go-server-deployment-84ddfbc887-t7d6v,520073,2,0,0,0,0
0,0,1,0,766704,1,go-server-deployment-84ddfbc887-7hh5k,766703,1,0,0,0,0
231526,0,2,0,216309,2,go-server-deployment-56dd4c9fc7-4j7kv,216307,2,0,0,0,0
0,0,1,0,355379,1,go-server-deployment-84ddfbc887-fz78f,355378,1,0,0,0,0
11961,0,0,0,239782,0,go-server-deployment-56dd4c9fc7-cfdfh,239782,0,0,0,0,0
771968,0,0,0,310147,0,go-server-deployment-84ddfbc887-674fn,310147,0,0,0,0,0
262593,0,1,0,143766,1,go-server-deployment-56dd4c9fc7-g82qm,143765,1,0,0,0,0
822997,0,1,0,266177,2,go-server-deployment-84ddfbc887-r5zvb,266175,2,0,0,0,0
783466,0,0,0,1013875,0,go-server-deployment-84ddfbc887-69l22,1013875,0,0,0,0,0
457244,0,0,0,647370,0,go-server-deployment-56dd4c9fc7-rdmqv,647370,0,0,0,0,0
0,0,0,0,654998,0,go-server-deployment-56dd4c9fc7-xr56l,654998,0,0,0,0,0
197630,0,0,0,220078,0,go-server-deployment-56dd4c9fc7-cwvqm,220078,0,0,0,0,0
0,0,0,0,306711,0,go-server-deployment-56dd4c9fc7-2vzj2,306711,0,0,0,0,0
1132630,0,2,0,801375,2,go-server-deployment-84ddfbc887-m8skb,801373,2,0,0,0,0
4101,0,2,0,975655,2,go-server-deployment-84ddfbc887-h7949,975653,2,0,0,0,0
0,0,1,0,599418,1,go-server-deployment-84ddfbc887-rn5x7,599417,1,0,0,0,0
696638,0,0,0,582540,0,go-server-deployment-56dd4c9fc7-v8hjw,582540,0,0,0,0,0
0,0,0,0,248886,0,go-server-deployment-84ddfbc887-rzzrl,248886,0,0,0,0,0
5852,0,1,0,307095,1,go-server-deployment-84ddfbc887-nnd9s,307094,1,0,0,0,0
0,0,5,0,379268,5,go-server-deployment-56dd4c9fc7-5z95d,379263,5,0,0,0,0
123919,0,0,0,415188,0,go-server-deployment-84ddfbc887-gsgqw,415188,0,0,0,0,0
494257,0,0,0,606415,0,go-server-deployment-56dd4c9fc7-n2xpd,606415,0,0,0,0,0
644107,0,1,0,371844,1,go-server-deployment-56dd4c9fc7-cwb62,371843,1,0,0,0,0
481545,0,1,0,157700,1,go-server-deployment-56dd4c9fc7-tns7w,157699,1,0,0,0,0
0,0,1,0,583476,1,go-server-deployment-56dd4c9fc7-4hkzw,583475,1,0,0,0,0
1832443,0,1,0,283344,2,go-server-deployment-84ddfbc887-9kd72,283342,2,0,0,0,0
0,0,0,0,300143,0,go-server-deployment-56dd4c9fc7-qdxp6,300143,0,0,0,0,0
0,0,1,0,323798,1,go-server-deployment-56dd4c9fc7-d9w6h,323797,1,0,0,0,0
366062,0,0,0,277232,0,go-server-deployment-84ddfbc887-9bmmj,277232,0,0,0,0,0
799142,0,2,0,910077,3,go-server-deployment-84ddfbc887-7rwtm,910074,3,0,0,0,0
527147,0,11,0,122335,11,go-server-deployment-56dd4c9fc7-s44r9,122324,11,0,0,0,0
0,0,0,0,226088,0,go-server-deployment-56dd4c9fc7-bfhlr,226088,0,0,0,0,0
578975,0,0,0,1134014,0,go-server-deployment-84ddfbc887-lkl8d,1134014,0,0,0,0,0
1137,0,2,0,260467,2,go-server-deployment-56dd4c9fc7-p79x6,260465,2,0,0,0,0
33961,0,2,0,690456,2,go-server-deployment-56dd4c9fc7-665wl,690454,2,0,0,0,0
0,0,0,0,369137,0,go-server-deployment-84ddfbc887-57bqb,369137,0,0,0,0,0
0,0,0,0,290927,0,go-server-deployment-84ddfbc887-4nx4c,290927,0,0,0,0,0
4543065,0,0,0,618799,0,go-server-deployment-84ddfbc887-bwd46,618799,0,0,0,0,0
58361,0,0,0,916475,0,go-server-deployment-84ddfbc887-wfwxg,916475,0,0,0,0,0
598602,0,0,0,175125,0,go-server-deployment-56dd4c9fc7-znj4v,175125,0,0,0,0,0
1200372,0,0,0,695974,0,go-server-deployment-84ddfbc887-fmvnc,695974,0,0,0,0,0
2562912,0,0,0,292180,0,go-server-deployment-84ddfbc887-9kxpr,292180,0,0,0,0,0
0,0,0,0,487999,0,go-server-deployment-84ddfbc887-s2m6t,487999,0,0,0,0,0
1528891,0,10,0,203045,10,go-server-deployment-56dd4c9fc7-7jq4h,203035,10,0,0,0,0
0,0,0,0,387117,0,go-server-deployment-84ddfbc887-rtzkd,387117,0,0,0,0,0
790306,0,0,0,187564,0,go-server-deployment-84ddfbc887-gzgc4,187564,0,0,0,0,0
40125,0,1,0,244670,1,go-server-deployment-56dd4c9fc7-zq89j,244669,1,0,0,0,0
0,0,0,0,610129,0,go-server-deployment-56dd4c9fc7-tpzzs,610129,0,0,0,0,0
0,0,0,0,343358,0,go-server-deployment-84ddfbc887-dss7w,343358,0,0,0,0,0
0,0,0,0,355642,0,go-server-deployment-84ddfbc887-wdmsm,355642,0,0,0,0,0
5223,0,1,0,701824,1,go-server-deployment-84ddfbc887-bfrqh,701823,1,0,0,0,0
444285,0,4,0,401729,4,go-server-deployment-56dd4c9fc7-zxc44,401725,4,0,0,0,0
511220,0,0,0,652078,0,go-server-deployment-56dd4c9fc7-8mdzv,652078,0,0,0,0,0
0,0,0,0,166242,0,go-server-deployment-56dd4c9fc7-lqj8b,166242,0,0,0,0,0
0,0,0,0,201278,0,go-server-deployment-56dd4c9fc7-g52rv,201278,0,0,0,0,0
0,0,1,0,207581,2,go-server-deployment-56dd4c9fc7-kbbk5,207579,2,0,0,0,0
653319,0,0,0,214937,1,go-server-deployment-84ddfbc887-7pkv6,214936,1,0,0,0,0
692071,0,0,0,351094,0,go-server-deployment-84ddfbc887-shntf,351094,0,0,0,0,0
0,0,0,0,257631,0,go-server-deployment-56dd4c9fc7-qzsfj,257631,0,0,0,0,0
0,0,0,0,240921,0,go-server-deployment-56dd4c9fc7-7v8k9,240921,0,0,0,0,0
0,0,0,0,222740,0,go-server-deployment-84ddfbc887-wzt2z,222740,0,0,0,0,0
229720,0,6,0,241768,6,go-server-deployment-56dd4c9fc7-t5jgm,241762,6,0,0,0,0
0,0,1,0,142726,1,go-server-deployment-84ddfbc887-wjrt7,142725,1,0,0,0,0
214699,0,0,0,992222,0,go-server-deployment-84ddfbc887-zdsr8,992222,0,0,0,0,0
1194851,0,2,0,868709,2,go-server-deployment-84ddfbc887-z7wfk,868707,2,0,0,0,0
3548093,0,0,0,1219023,0,go-server-deployment-56dd4c9fc7-mjzf8,1219023,0,0,0,0,0
0,0,1,0,245732,1,go-server-deployment-56dd4c9fc7-7fn27,245731,1,0,0,0,0
350575,0,2,0,303777,2,go-server-deployment-56dd4c9fc7-q6mjm,303775,2,0,0,0,0
282133,0,0,0,317003,0,go-server-deployment-84ddfbc887-tjp4r,317003,0,0,0,0,0
0,0,0,0,522206,0,go-server-deployment-56dd4c9fc7-rz4mg,522206,0,0,0,0,0
45156,0,0,0,584456,0,go-server-deployment-56dd4c9fc7-v2n7q,584456,0,0,0,0,0
569059,0,0,0,452639,1,go-server-deployment-56dd4c9fc7-dm4fh,452638,1,0,0,0,0
1499706,0,1,0,242955,1,go-server-deployment-84ddfbc887-987bd,242954,1,0,0,0,0
0,0,0,0,221192,0,go-server-deployment-56dd4c9fc7-s7fcv,221192,0,0,0,0,0
134526,0,5,0,323625,5,go-server-deployment-56dd4c9fc7-fcxrb,323620,5,0,0,0,0
251511,0,1,0,438044,1,go-server-deployment-84ddfbc887-b77wt,438043,1,0,0,0,0
500266,0,1,0,274432,1,go-server-deployment-84ddfbc887-7d7w4,274431,1,0,0,0,0
0,0,1,0,444345,1,go-server-deployment-84ddfbc887-wpqgv,444344,1,0,0,0,0
1554518,0,4,0,378420,4,go-server-deployment-56dd4c9fc7-gjmkc,378416,4,0,0,0,0
0,0,1,0,880107,1,go-server-deployment-84ddfbc887-zmhhm,880106,1,0,0,0,0
221042,0,0,0,259418,0,go-server-deployment-56dd4c9fc7-575gc,259418,0,0,0,0,0
0,0,1,0,99618,1,go-server-deployment-56dd4c9fc7-q5kpz,99617,1,0,0,0,0
0,0,1,0,130478,1,go-server-deployment-56dd4c9fc7-vr4ld,130477,1,0,0,0,0
0,0,0,0,932186,0,go-server-deployment-84ddfbc887-cjsfn,932186,0,0,0,0,0
2668636,0,0,0,525257,0,go-server-deployment-84ddfbc887-nlvcj,525257,0,0,0,0,0
700803,0,1,0,255566,1,go-server-deployment-56dd4c9fc7-wqm2h,255565,1,0,0,0,0
629075,0,2,0,182635,2,go-server-deployment-56dd4c9fc7-svlr2,182633,2,0,0,0,0
258122,0,1,0,176518,1,go-server-deployment-56dd4c9fc7-cd2cp,176517,1,0,0,0,0
0,0,0,0,329642,0,go-server-deployment-84ddfbc887-tgmjj,329642,0,0,0,0,0
1766287,0,34,0,775184,34,go-server-deployment-56dd4c9fc7-wzx2c,775150,34,0,0,0,0
794969,0,1,0,154240,1,go-server-deployment-56dd4c9fc7-kgdth,154239,1,0,0,0,0
557745,0,0,0,149603,0,go-server-deployment-56dd4c9fc7-2gmzm,149603,0,0,0,0,0
0,0,3,0,918859,3,go-server-deployment-84ddfbc887-5zgll,918856,3,0,0,0,0
83288,0,0,0,369025,0,go-server-deployment-84ddfbc887-47ztj,369025,0,0,0,0,0
10545,0,0,0,412280,0,go-server-deployment-84ddfbc887-lrfrr,412280,0,0,0,0,0
312248,0,3,0,339897,3,go-server-deployment-56dd4c9fc7-n8km4,339894,3,0,0,0,0
0,0,0,0,662440,0,go-server-deployment-56dd4c9fc7-26mm5,662440,0,0,0,0,0
675538,0,0,0,216488,0,go-server-deployment-84ddfbc887-q6r44,216488,0,0,0,0,0
1594287,0,4,0,447361,4,go-server-deployment-56dd4c9fc7-w2zvb,447357,4,0,0,0,0
1281323,0,0,0,382791,0,go-server-deployment-84ddfbc887-jqrkf,382791,0,0,0,0,0
0,0,0,0,438839,0,go-server-deployment-56dd4c9fc7-thj6x,438839,0,0,0,0,0
353897,0,0,0,187895,0,go-server-deployment-56dd4c9fc7-bc2vc,187895,0,0,0,0,0
0,0,0,0,285095,0,go-server-deployment-84ddfbc887-ptvvn,285095,0,0,0,0,0
140754,0,21,0,479589,21,go-server-deployment-56dd4c9fc7-hw7ms,479568,21,0,0,0,0
956961,0,3,0,525145,3,go-server-deployment-56dd4c9fc7-t7t9v,525142,3,0,0,0,0
0,0,0,0,379929,0,go-server-deployment-84ddfbc887-nxn24,379929,0,0,0,0,0
154839,0,0,0,383988,0,go-server-deployment-56dd4c9fc7-tdhkv,383988,0,0,0,0,0
0,0,0,0,500064,0,go-server-deployment-84ddfbc887-fvzhx,500064,0,0,0,0,0
0,0,0,0,308208,0,go-server-deployment-84ddfbc887-66xm2,308208,0,0,0,0,0
0,0,0,0,60367,0,go-server-deployment-56dd4c9fc7-2vxnd,60367,0,0,0,0,0
0,0,0,0,627019,0,go-server-deployment-84ddfbc887-86n8t,627019,0,0,0,0,0
1153996,0,0,0,259806,0,go-server-deployment-84ddfbc887-z6tgb,259806,0,0,0,0,0
0,0,0,0,260982,0,go-server-deployment-84ddfbc887-8vck6,260982,0,0,0,0,0
317556,0,0,0,789339,0,go-server-deployment-84ddfbc887-9h8fm,789339,0,0,0,0,0
2842,0,1,0,588471,1,go-server-deployment-84ddfbc887-jvhqk,588470,1,0,0,0,0
193573,0,0,0,997918,0,go-server-deployment-84ddfbc887-wfnj9,997918,0,0,0,0,0
1550690,0,0,0,1239929,0,go-server-deployment-84ddfbc887-n2v9b,1239929,0,0,0,0,0
154148,0,3,0,534153,3,go-server-deployment-56dd4c9fc7-zwbj4,534150,3,0,0,0,0
0,0,0,0,403791,0,go-server-deployment-56dd4c9fc7-2n8q8,403791,0,0,0,0,0
324014,0,0,0,586665,0,go-server-deployment-84ddfbc887-4fr4h,586665,0,0,0,0,0
22900,0,0,0,1078817,0,go-server-deployment-84ddfbc887-6qn2x,1078817,0,0,0,0,0
0,0,1,0,382504,1,go-server-deployment-84ddfbc887-gwk87,382503,1,0,0,0,0
0,0,1,0,606061,1,go-server-deployment-84ddfbc887-dmn66,606060,1,0,0,0,0
0,0,0,0,327656,0,go-server-deployment-56dd4c9fc7-hj7sq,327656,0,0,0,0,0
0,0,0,0,472774,0,go-server-deployment-56dd4c9fc7-mhsb6,472774,0,0,0,0,0
548255,0,0,0,238815,0,go-server-deployment-84ddfbc887-cwrd7,238815,0,0,0,0,0
410344,0,0,0,1282886,0,go-server-deployment-84ddfbc887-n9fqz,1282886,0,0,0,0,0
163113,0,0,0,467176,0,go-server-deployment-56dd4c9fc7-n7qmd,467176,0,0,0,0,0
108439,0,0,0,635056,0,go-server-deployment-84ddfbc887-c5sqd,635056,0,0,0,0,0
202512,0,0,0,165620,0,go-server-deployment-56dd4c9fc7-zgjv4,165620,0,0,0,0,0
0,0,0,0,393357,0,go-server-deployment-84ddfbc887-vn9ss,393357,0,0,0,0,0
0,0,0,0,547523,0,go-server-deployment-84ddfbc887-jr6cn,547523,0,0,0,0,0
1039283,0,2,0,386893,2,go-server-deployment-56dd4c9fc7-mgrs5,386891,2,0,0,0,0
187617,0,0,0,157335,0,go-server-deployment-56dd4c9fc7-z89q8,157335,0,0,0,0,0
0,0,0,0,268847,0,go-server-deployment-56dd4c9fc7-79bjk,268847,0,0,0,0,0
423847,0,4,0,582808,4,go-server-deployment-84ddfbc887-df62t,582804,4,0,0,0,0
1419,0,0,0,1055592,0,go-server-deployment-84ddfbc887-cj9nm,1055592,0,0,0,0,0
31932,0,1,0,339627,1,go-server-deployment-56dd4c9fc7-68j6j,339626,1,0,0,0,0
196087,0,0,0,253216,0,go-server-deployment-56dd4c9fc7-5qftx,253216,0,0,0,0,0
0,0,0,0,291978,0,go-server-deployment-56dd4c9fc7-lzrfh,291978,0,0,0,0,0
1230634,0,0,0,168536,0,go-server-deployment-84ddfbc887-vjrzj,168536,0,0,0,0,0
0,0,0,0,425335,0,go-server-deployment-84ddfbc887-j6kk5,425335,0,0,0,0,0
128978,0,3,0,281255,3,go-server-deployment-56dd4c9fc7-c9l2x,281252,3,0,0,0,0
4083,0,3,0,432920,3,go-server-deployment-56dd4c9fc7-k8h6g,432917,3,0,0,0,0
0,0,0,0,261106,0,go-server-deployment-56dd4c9fc7-4ws7d,261106,0,0,0,0,0
680553,0,2,0,192403,2,go-server-deployment-84ddfbc887-6tsmf,192401,2,0,0,0,0
1451,0,0,0,369925,0,go-server-deployment-84ddfbc887-vqt7r,369925,0,0,0,0,0
0,0,1,0,377288,1,go-server-deployment-84ddfbc887-xdc7s,377287,1,0,0,0,0
2453245,0,0,0,559131,1,go-server-deployment-84ddfbc887-fqjqj,559130,1,0,0,0,0
0,0,0,0,995598,0,go-server-deployment-84ddfbc887-5r77n,995598,0,0,0,0,0
341249,0,0,0,202253,0,go-server-deployment-56dd4c9fc7-vnlxf,202253,0,0,0,0,0
0,0,0,0,240374,0,go-server-deployment-84ddfbc887-7bj24,240374,0,0,0,0,0
0,0,0,0,319722,0,go-server-deployment-56dd4c9fc7-788jj,319722,0,0,0,0,0
0,0,0,0,254742,0,go-server-deployment-56dd4c9fc7-n8565,254742,0,0,0,0,0
1225166,0,2,0,519392,2,go-server-deployment-84ddfbc887-dznlb,519390,2,0,0,0,0
1230556,0,3,0,398438,3,go-server-deployment-84ddfbc887-fbrgt,398435,3,0,0,0,0
402046,0,0,0,394063,0,go-server-deployment-84ddfbc887-gpsvk,394063,0,0,0,0,0
433213,0,15,0,246810,15,go-server-deployment-56dd4c9fc7-k8rzc,246795,15,0,0,0,0
535174,0,0,0,718523,0,go-server-deployment-84ddfbc887-t8gr6,718523,0,0,0,0,0
1010851,0,2,0,317576,2,go-server-deployment-84ddfbc887-z5jbb,317574,2,0,0,0,0
0,0,1,0,731600,1,go-server-deployment-56dd4c9fc7-frbqw,731599,1,0,0,0,0
0,0,1,0,221947,1,go-server-deployment-56dd4c9fc7-kkfm4,221946,1,0,0,0,0
1260603,0,0,0,393302,0,go-server-deployment-84ddfbc887-2qhv9,393302,0,0,0,0,0
3694,0,0,0,110844,0,go-server-deployment-56dd4c9fc7-4pzk5,110844,0,0,0,0,0
344223,0,0,0,273422,0,go-server-deployment-84ddfbc887-n84kt,273422,0,0,0,0,0
0,0,2,0,230220,2,go-server-deployment-56dd4c9fc7-jvzt2,230218,2,0,0,0,0
0,0,0,0,255368,0,go-server-deployment-56dd4c9fc7-4wcgz,255368,0,0,0,0,0
370957,0,1,0,332268,1,go-server-deployment-56dd4c9fc7-dtxpg,332267,1,0,0,0,0
0,0,0,0,484419,0,go-server-deployment-84ddfbc887-skrh4,484419,0,0,0,0,0
38581,0,1,0,73422,1,go-server-deployment-56dd4c9fc7-wp9hl,73421,1,0,0,0,0
318128,0,3,0,716444,3,go-server-deployment-84ddfbc887-h6zxn,716441,3,0,0,0,0
311809,0,7,0,191745,7,go-server-deployment-56dd4c9fc7-4chwq,191738,7,0,0,0,0
0,0,1,0,154247,1,go-server-deployment-56dd4c9fc7-92jv5,154246,1,0,0,0,0
458368,0,3,0,549780,3,go-server-deployment-56dd4c9fc7-5vr5x,549777,3,0,0,0,0
469338,0,2,0,367388,2,go-server-deployment-84ddfbc887-242kr,367386,2,0,0,0,0
872964,0,2,0,405434,2,go-server-deployment-56dd4c9fc7-57fzd,405432,2,0,0,0,0
14233,0,0,0,208412,0,go-server-deployment-84ddfbc887-6568k,208412,0,0,0,0,0
524582,0,1,0,377657,1,go-server-deployment-56dd4c9fc7-klhmh,377656,1,0,0,0,0
1907,0,3,0,459909,3,go-server-deployment-84ddfbc887-zx6tz,459906,3,0,0,0,0
0,0,0,0,271571,0,go-server-deployment-56dd4c9fc7-v7zr2,271571,0,0,0,0,0
323895,0,5,0,320372,5,go-server-deployment-56dd4c9fc7-cxdqw,320367,5,0,0,0,0
765777,0,0,0,255820,0,go-server-deployment-84ddfbc887-nlwjk,255820,0,0,0,0,0
0,0,3,0,503831,3,go-server-deployment-56dd4c9fc7-sdmpg,503828,3,0,0,0,0
867209,0,19,0,523100,19,go-server-deployment-56dd4c9fc7-mwj8g,523081,19,0,0,0,0
0,0,0,0,325566,0,go-server-deployment-56dd4c9fc7-bp7xj,325566,0,0,0,0,0
0,0,0,0,190814,0,go-server-deployment-56dd4c9fc7-xpnzd,190814,0,0,0,0,0
0,0,1,0,467692,1,go-server-deployment-56dd4c9fc7-424f4,467691,1,0,0,0,0
0,0,1,0,157097,1,go-server-deployment-56dd4c9fc7-rn5qq,157096,1,0,0,0,0
1428,0,2,0,93329,2,go-server-deployment-56dd4c9fc7-j7sf8,93327,2,0,0,0,0
824178,0,2,0,292405,2,go-server-deployment-84ddfbc887-s42s4,292403,2,0,0,0,0
5706,0,2,0,502087,2,go-server-deployment-84ddfbc887-f998g,502085,2,0,0,0,0
0,0,0,0,398141,0,go-server-deployment-84ddfbc887-4vnj2,398141,0,0,0,0,0
835098,0,0,0,244695,0,go-server-deployment-84ddfbc887-26pcj,244695,0,0,0,0,0
0,0,0,0,326569,0,go-server-deployment-56dd4c9fc7-7wlf2,326569,0,0,0,0,0
0,0,0,0,500643,0,go-server-deployment-56dd4c9fc7-fkrrd,500643,0,0,0,0,0
2254351,0,0,0,307326,0,go-server-deployment-84ddfbc887-xr7x5,307326,0,0,0,0,0
1044332,0,1,0,852121,1,go-server-deployment-84ddfbc887-rx2qf,852120,1,0,0,0,0
1024083,0,1,0,590827,1,go-server-deployment-84ddfbc887-wjd7k,590826,1,0,0,0,0
0,0,0,0,714197,0,go-server-deployment-84ddfbc887-hhtnv,714197,0,0,0,0,0
2267715,0,2,0,601364,2,go-server-deployment-56dd4c9fc7-rhfsh,601362,2,0,0,0,0
458393,0,0,0,478396,0,go-server-deployment-84ddfbc887-z6bgz,478396,0,0,0,0,0
0,0,0,0,128016,0,go-server-deployment-56dd4c9fc7-7pt5j,128016,0,0,0,0,0
2578816,0,0,0,296374,0,go-server-deployment-84ddfbc887-v8vsr,296374,0,0,0,0,0
0,0,0,0,244100,0,go-server-deployment-84ddfbc887-lxxjw,244100,0,0,0,0,0
538483,0,0,0,234284,1,go-server-deployment-84ddfbc887-vlxgx,234283,1,0,0,0,0
698053,0,0,0,436925,0,go-server-deployment-56dd4c9fc7-29n4v,436925,0,0,0,0,0
0,0,1,0,428119,1,go-server-deployment-56dd4c9fc7-tj5qt,428118,1,0,0,0,0
334943,0,2,0,331616,2,go-server-deployment-84ddfbc887-h55w2,331614,2,0,0,0,0
259677,0,3,0,133796,3,go-server-deployment-56dd4c9fc7-xqgw2,133793,3,0,0,0,0
0,0,0,0,407550,0,go-server-deployment-84ddfbc887-h8lg6,407550,0,0,0,0,0
0,0,0,0,353738,0,go-server-deployment-56dd4c9fc7-mf7wj,353738,0,0,0,0,0
1526234,0,0,0,688794,0,go-server-deployment-84ddfbc887-qf794,688794,0,0,0,0,0
0,0,4,0,344877,4,go-server-deployment-56dd4c9fc7-wmhdr,344873,4,0,0,0,0
1000130,0,7,0,346718,7,go-server-deployment-56dd4c9fc7-48tg2,346711,7,0,0,0,0
1526142,0,3,0,575690,3,go-server-deployment-84ddfbc887-xjpn5,575687,3,0,0,0,0
2178,0,0,0,299679,0,go-server-deployment-56dd4c9fc7-g5jqp,299679,0,0,0,0,0
578319,0,0,0,296394,0,go-server-deployment-84ddfbc887-r5kq4,296394,0,0,0,0,0
415724,0,2,0,509017,2,go-server-deployment-84ddfbc887-t6xfq,509015,2,0,0,0,0
582170,0,9,0,102146,9,go-server-deployment-56dd4c9fc7-5t7mp,102137,9,0,0,0,0
1162446,0,1,0,1260542,1,go-server-deployment-84ddfbc887-pzhd4,1260541,1,0,0,0,0
0,0,0,0,261933,1,go-server-deployment-56dd4c9fc7-hnwm2,261932,1,0,0,0,0
293730,0,0,0,384209,0,go-server-deployment-84ddfbc887-pt7cm,384209,0,0,0,0,0
281830,0,3,0,110992,3,go-server-deployment-56dd4c9fc7-p5fj9,110989,3,0,0,0,0
0,0,0,0,1391054,0,go-server-deployment-84ddfbc887-l98tw,1391054,0,0,0,0,0
1097,0,0,0,859320,0,go-server-deployment-84ddfbc887-jhzx8,859320,0,0,0,0,0
650870,0,0,0,467698,0,go-server-deployment-84ddfbc887-8dzs9,467698,0,0,0,0,0
0,0,1,0,384155,1,go-server-deployment-56dd4c9fc7-76mcf,384154,1,0,0,0,0
1039493,0,0,0,216025,0,go-server-deployment-56dd4c9fc7-br7qv,216025,0,0,0,0,0
3028,0,2,0,601232,2,go-server-deployment-84ddfbc887-g46wr,601230,2,0,0,0,0
0,0,0,0,456137,0,go-server-deployment-56dd4c9fc7-wnnjr,456137,0,0,0,0,0
686603,0,0,0,765425,0,go-server-deployment-84ddfbc887-55mbl,765425,0,0,0,0,0
1774863,0,0,0,359365,0,go-server-deployment-84ddfbc887-c69t4,359365,0,0,0,0,0
0,0,1,0,364628,1,go-server-deployment-84ddfbc887-8xrfj,364627,1,0,0,0,0
1756942,0,0,0,420685,0,go-server-deployment-84ddfbc887-468k4,420685,0,0,0,0,0
1005253,0,0,0,311733,0,go-server-deployment-84ddfbc887-sj2qw,311733,0,0,0,0,0
0,0,0,0,375602,0,go-server-deployment-56dd4c9fc7-jp64c,375602,0,0,0,0,0
366372,0,0,0,790250,0,go-server-deployment-84ddfbc887-vp4x2,790250,0,0,0,0,0
1204294,0,0,0,254142,0,go-server-deployment-56dd4c9fc7-5wr4m,254142,0,0,0,0,0
8612,0,0,0,327595,0,go-server-deployment-84ddfbc887-st2l5,327595,0,0,0,0,0
1378478,0,0,0,666150,0,go-server-deployment-84ddfbc887-hgsvw,666150,0,0,0,0,0
246422,0,0,0,203230,0,go-server-deployment-84ddfbc887-xnm9x,203230,0,0,0,0,0
0,0,0,0,392513,0,go-server-deployment-56dd4c9fc7-27k55,392513,0,0,0,0,0
177072,0,0,0,230713,0,go-server-deployment-56dd4c9fc7-wmrmg,230713,0,0,0,0,0
0,0,1,0,589602,1,go-server-deployment-56dd4c9fc7-9xtgj,589601,1,0,0,0,0
0,0,0,0,906582,0,go-server-deployment-84ddfbc887-4sph4,906582,0,0,0,0,0
237962,0,0,0,230516,0,go-server-deployment-56dd4c9fc7-8rzf9,230516,0,0,0,0,0
549797,0,2,0,778575,2,go-server-deployment-84ddfbc887-wvcg2,778573,2,0,0,0,0
0,0,0,0,516699,0,go-server-deployment-84ddfbc887-ctvjs,516699,0,0,0,0,0
0,0,0,0,167302,0,go-server-deployment-56dd4c9fc7-qjghs,167302,0,0,0,0,0
1443599,0,1,0,773291,1,go-server-deployment-84ddfbc887-86c96,773290,1,0,0,0,0
0,0,0,0,312285,0,go-server-deployment-84ddfbc887-wlqt8,312285,0,0,0,0,0
0,0,0,0,365101,0,go-server-deployment-56dd4c9fc7-mnqcx,365101,0,0,0,0,0
412574,0,0,0,224102,0,go-server-deployment-84ddfbc887-r45ct,224102,0,0,0,0,0
0,0,3,0,479379,3,go-server-deployment-56dd4c9fc7-pq4ls,479376,3,0,0,0,0
0,0,2,0,564648,2,go-server-deployment-56dd4c9fc7-65ph2,564646,2,0,0,0,0
0,0,1,0,212686,1,go-server-deployment-56dd4c9fc7-mlgb8,212685,1,0,0,0,0
58959,0,1,0,397962,1,go-server-deployment-84ddfbc887-wzmbn,397961,1,0,0,0,0
1625292,0,0,0,980584,0,go-server-deployment-84ddfbc887-6dn9m,980584,0,0,0,0,0
694565,0,1,0,266933,1,go-server-deployment-84ddfbc887-xhj4v,266932,1,0,0,0,0
302600,0,1,0,283730,1,go-server-deployment-56dd4c9fc7-c9skt,283729,1,0,0,0,0
1594200,0,1,0,1081197,1,go-server-deployment-84ddfbc887-66pb6,1081196,1,0,0,0,0
522141,0,0,0,420038,0,go-server-deployment-84ddfbc887-jxdbg,420038,0,0,0,0,0
610599,0,28,0,99275,28,go-server-deployment-56dd4c9fc7-d5g4g,99247,28,0,0,0,0
0,0,0,0,352336,0,go-server-deployment-56dd4c9fc7-pbh8x,352336,0,0,0,0,0
501417,0,0,0,541116,0,go-server-deployment-56dd4c9fc7-zjgwx,541116,0,0,0,0,0
2461774,0,7,0,342296,7,go-server-deployment-84ddfbc887-hdb72,342289,7,0,0,0,0
944541,0,0,0,507671,0,go-server-deployment-84ddfbc887-dh9gr,507671,0,0,0,0,0
519850,0,1,0,162903,1,go-server-deployment-56dd4c9fc7-c2wvh,162902,1,0,0,0,0
3634759,0,0,0,239821,0,go-server-deployment-84ddfbc887-jthth,239821,0,0,0,0,0
711842,0,0,0,228727,1,go-server-deployment-84ddfbc887-rk9qf,228726,1,0,0,0,0
325957,0,0,0,150579,0,go-server-deployment-56dd4c9fc7-xmd8v,150579,0,0,0,0,0
495295,0,31,0,127928,31,go-server-deployment-56dd4c9fc7-tvlbm,127897,31,0,0,0,0
1655194,0,32,0,170311,32,go-server-deployment-56dd4c9fc7-hwrw2,170279,32,0,0,0,0
296090,0,2,0,233512,2,go-server-deployment-56dd4c9fc7-6kxdd,233510,2,0,0,0,0
77349,0,2,0,1452304,2,go-server-deployment-84ddfbc887-9ljc2,1452302,2,0,0,0,0
0,0,0,0,827337,0,go-server-deployment-84ddfbc887-zrvj4,827337,0,0,0,0,0
0,0,0,0,202008,0,go-server-deployment-56dd4c9fc7-qgk4c,202008,0,0,0,0,0
227656,0,0,0,193635,0,go-server-deployment-56dd4c9fc7-pcgkl,193635,0,0,0,0,0
0,0,0,0,926724,0,go-server-deployment-84ddfbc887-fqqsk,926724,0,0,0,0,0
1007149,0,2,0,628035,2,go-server-deployment-84ddfbc887-rctmz,628033,2,0,0,0,0
225136,0,0,0,203727,0,go-server-deployment-56dd4c9fc7-fgq9l,203727,0,0,0,0,0
15274,0,0,0,478219,0,go-server-deployment-84ddfbc887-8jrfm,478219,0,0,0,0,0
0,0,0,0,534780,0,go-server-deployment-56dd4c9fc7-6kcjk,534780,0,0,0,0,0
367758,0,0,0,116049,0,go-server-deployment-56dd4c9fc7-czkpn,116049,0,0,0,0,0
421592,0,3,0,165286,3,go-server-deployment-56dd4c9fc7-dnqs2,165283,3,0,0,0,0
1119981,0,16,0,474694,16,go-server-deployment-56dd4c9fc7-rzlpt,474678,16,0,0,0,0
1618639,0,16,0,531045,16,go-server-deployment-56dd4c9fc7-zx78b,531029,16,0,0,0,0
871695,0,0,0,453961,0,go-server-deployment-84ddfbc887-x2ccb,453961,0,0,0,0,0
1109958,0,2,0,422497,2,go-server-deployment-56dd4c9fc7-tzxxt,422495,2,0,0,0,0
76102,0,0,0,458981,0,go-server-deployment-56dd4c9fc7-dlmnm,458981,0,0,0,0,0
0,0,2,0,223465,2,go-server-deployment-56dd4c9fc7-22f8t,223463,2,0,0,0,0
0,0,0,0,877429,0,go-server-deployment-84ddfbc887-b66np,877429,0,0,0,0,0
466969,0,0,0,463975,0,go-server-deployment-84ddfbc887-b8gfb,463975,0,0,0,0,0
815035,0,1,0,301532,1,go-server-deployment-84ddfbc887-47ppc,301531,1,0,0,0,0
0,0,0,0,488856,0,go-server-deployment-56dd4c9fc7-l5lw4,488856,0,0,0,0,0
661902,0,0,0,256306,0,go-server-deployment-84ddfbc887-4cdtp,256306,0,0,0,0,0
0,0,0,0,359272,0,go-server-deployment-56dd4c9fc7-lrkg6,359272,0,0,0,0,0
1283860,0,1,0,737671,1,go-server-deployment-84ddfbc887-tr48b,737670,1,0,0,0,0
617489,0,4,0,364048,4,go-server-deployment-84ddfbc887-b2fs5,364044,4,0,0,0,0
0,0,0,0,306186,0,go-server-deployment-56dd4c9fc7-bx5dm,306186,0,0,0,0,0
286421,0,2,0,153543,2,go-server-deployment-56dd4c9fc7-qcpn8,153541,2,0,0,0,0
126985,0,0,0,291340,0,go-server-deployment-84ddfbc887-g7vsf,291340,0,0,0,0,0
3817,0,0,0,1089338,0,go-server-deployment-84ddfbc887-rq5hm,1089338,0,0,0,0,0
0,0,0,0,507053,0,go-server-deployment-56dd4c9fc7-6jrxc,507053,0,0,0,0,0
386140,0,0,0,591958,0,go-server-deployment-84ddfbc887-29xk6,591958,0,0,0,0,0
0,0,0,0,375562,0,go-server-deployment-56dd4c9fc7-nm8pb,375562,0,0,0,0,0
397070,0,0,0,217374,0,go-server-deployment-84ddfbc887-r4lkg,217374,0,0,0,0,0
1217560,0,2,0,363984,2,go-server-deployment-56dd4c9fc7-r2942,363982,2,0,0,0,0
0,0,0,0,790155,0,go-server-deployment-84ddfbc887-kp9hh,790155,0,0,0,0,0
248917,0,3,0,166924,3,go-server-deployment-56dd4c9fc7-btz9f,166921,3,0,0,0,0
795313,0,4,0,166846,5,go-server-deployment-84ddfbc887-lgnt6,166841,5,0,0,0,0
336249,0,2,0,284847,2,go-server-deployment-84ddfbc887-4vbp4,284845,2,0,0,0,0
287076,0,1,0,274308,1,go-server-deployment-56dd4c9fc7-9pdlt,274307,1,0,0,0,0
1735060,0,0,0,911403,0,go-server-deployment-84ddfbc887-drm7c,911403,0,0,0,0,0
774077,0,0,0,834581,0,go-server-deployment-84ddfbc887-fj7x7,834581,0,0,0,0,0
585699,0,0,0,279766,0,go-server-deployment-84ddfbc887-jb67p,279766,0,0,0,0,0
0,0,0,0,1000314,0,go-server-deployment-84ddfbc887-kdztc,1000314,0,0,0,0,0
0,0,0,0,952805,0,go-server-deployment-84ddfbc887-mqkrx,952805,0,0,0,0,0
699042,0,1,0,759490,1,go-server-deployment-84ddfbc887-g6bzr,759489,1,0,0,0,0
534824,0,0,0,275575,0,go-server-deployment-56dd4c9fc7-lkmhx,275575,0,0,0,0,0
143723,0,2,0,184902,2,go-server-deployment-56dd4c9fc7-pfbnd,184900,2,0,0,0,0
0,0,0,0,231157,0,go-server-deployment-56dd4c9fc7-sj9n6,231157,0,0,0,0,0
178919,0,0,0,181841,0,go-server-deployment-56dd4c9fc7-5xrtz,181841,0,0,0,0,0
696957,0,1,0,810022,1,go-server-deployment-56dd4c9fc7-4lqpq,810021,1,0,0,0,0
1589636,0,0,0,321113,0,go-server-deployment-84ddfbc887-75xln,321113,0,0,0,0,0
739803,0,1,0,216830,1,go-server-deployment-84ddfbc887-t7k8x,216829,1,0,0,0,0
0,0,0,0,1030415,0,go-server-deployment-84ddfbc887-lr767,1030415,0,0,0,0,0
2567120,0,9,0,798573,9,go-server-deployment-56dd4c9fc7-stnsl,798564,9,0,0,0,0
165268,0,9,0,283339,9,go-server-deployment-56dd4c9fc7-9lg4g,283330,9,0,0,0,0
0,0,0,0,291850,0,go-server-deployment-56dd4c9fc7-lvr4d,291850,0,0,0,0,0
0,0,0,0,269081,0,go-server-deployment-56dd4c9fc7-jks5j,269081,0,0,0,0,0
766312,0,0,0,799401,0,go-server-deployment-84ddfbc887-zhpxs,799401,0,0,0,0,0
0,0,0,0,122766,0,go-server-deployment-56dd4c9fc7-dfn4k,122766,0,0,0,0,0
0,0,0,0,294330,0,go-server-deployment-56dd4c9fc7-xwx68,294330,0,0,0,0,0
0,0,0,0,248347,0,go-server-deployment-84ddfbc887-gxr69,248347,0,0,0,0,0
0,0,1,0,292223,1,go-server-deployment-56dd4c9fc7-b6rcq,292222,1,0,0,0,0
792478,0,3,0,128092,3,go-server-deployment-56dd4c9fc7-dctgw,128089,3,0,0,0,0
0,0,1,0,189782,1,go-server-deployment-56dd4c9fc7-srnxv,189781,1,0,0,0,0
1992,0,0,0,633021,0,go-server-deployment-84ddfbc887-kn9sf,633021,0,0,0,0,0
420662,0,0,0,328991,0,go-server-deployment-56dd4c9fc7-pxfwp,328991,0,0,0,0,0
769188,0,4,0,690948,4,go-server-deployment-56dd4c9fc7-8tq6v,690944,4,0,0,0,0
372367,0,1,0,125603,1,go-server-deployment-56dd4c9fc7-pgc29,125602,1,0,0,0,0
0,0,1,0,299116,1,go-server-deployment-56dd4c9fc7-t7wb6,299115,1,0,0,0,0
205496,0,0,0,205617,0,go-server-deployment-56dd4c9fc7-l6j2r,205617,0,0,0,0,0
1229460,0,0,0,233087,0,go-server-deployment-56dd4c9fc7-vjlnp,233087,0,0,0,0,0
0,0,3,0,141638,3,go-server-deployment-56dd4c9fc7-8bbkw,141635,3,0,0,0,0
249928,0,0,0,488856,0,go-server-deployment-84ddfbc887-tbtwx,488856,0,0,0,0,0
0,0,0,0,310748,0,go-server-deployment-56dd4c9fc7-fxk65,310748,0,0,0,0,0
1028295,0,8,0,489841,8,go-server-deployment-56dd4c9fc7-cmhcq,489833,8,0,0,0,0
1682,0,0,0,726520,0,go-server-deployment-84ddfbc887-dg4gn,726520,0,0,0,0,0
183000,0,0,0,583001,0,go-server-deployment-84ddfbc887-n8zt6,583001,0,0,0,0,0
0,0,0,0,1000463,0,go-server-deployment-84ddfbc887-pfs8l,1000463,0,0,0,0,0
0,0,0,0,509803,0,go-server-deployment-56dd4c9fc7-qvk59,509803,0,0,0,0,0
471928,0,0,0,544545,0,go-server-deployment-56dd4c9fc7-rbqqc,544545,0,0,0,0,0
106502,0,0,0,648178,0,go-server-deployment-56dd4c9fc7-dgbx2,648178,0,0,0,0,0
27052,0,0,0,869174,0,go-server-deployment-84ddfbc887-c4ccf,869174,0,0,0,0,0
59544,0,33,0,226848,33,go-server-deployment-56dd4c9fc7-6s27w,226815,33,0,0,0,0
1530039,0,1,0,891565,2,go-server-deployment-84ddfbc887-s466s,891563,2,0,0,0,0
2090397,0,0,0,566449,0,go-server-deployment-84ddfbc887-fn64s,566449,0,0,0,0,0
0,0,0,0,417081,0,go-server-deployment-56dd4c9fc7-bx968,417081,0,0,0,0,0
0,0,0,0,360217,0,go-server-deployment-56dd4c9fc7-w8f84,360217,0,0,0,0,0
358868,0,0,0,317896,0,go-server-deployment-84ddfbc887-b5bxx,317896,0,0,0,0,0
293631,0,1,0,279420,1,go-server-deployment-84ddfbc887-nxs77,279419,1,0,0,0,0
33215,0,1,0,611985,1,go-server-deployment-84ddfbc887-7np5f,611984,1,0,0,0,0
291754,0,0,0,310372,0,go-server-deployment-56dd4c9fc7-4zszd,310372,0,0,0,0,0
0,0,0,0,476518,0,go-server-deployment-56dd4c9fc7-4dxxr,476518,0,0,0,0,0
0,0,0,0,444220,0,go-server-deployment-56dd4c9fc7-22nr7,444220,0,0,0,0,0
0,0,0,0,181524,0,go-server-deployment-56dd4c9fc7-t7dl2,181524,0,0,0,0,0
85210,0,1,0,299982,1,go-server-deployment-84ddfbc887-v2w2v,299981,1,0,0,0,0
1057930,0,0,0,410847,0,go-server-deployment-84ddfbc887-qqp89,410847,0,0,0,0,0
0,0,2,0,578010,2,go-server-deployment-56dd4c9fc7-2cm6c,578008,2,0,0,0,0
223076,0,4,0,745070,5,go-server-deployment-56dd4c9fc7-t9659,745065,5,0,0,0,0
0,0,2,0,65504,2,go-server-deployment-56dd4c9fc7-j7dsk,65502,2,0,0,0,0
0,0,1,0,381761,1,go-server-deployment-84ddfbc887-vwcs5,381760,1,0,0,0,0
485737,0,1,0,224674,1,go-server-deployment-56dd4c9fc7-xs8bn,224673,1,0,0,0,0
730304,0,1,0,932906,1,go-server-deployment-84ddfbc887-vzkjw,932905,1,0,0,0,0
142393,0,8,0,285857,8,go-server-deployment-56dd4c9fc7-b4x5m,285849,8,0,0,0,0
265011,0,1,0,514056,1,go-server-deployment-56dd4c9fc7-86w7q,514055,1,0,0,0,0
515473,0,1,0,620116,1,go-server-deployment-84ddfbc887-5pm8h,620115,1,0,0,0,0
460259,0,7,0,336540,7,go-server-deployment-56dd4c9fc7-shxc6,336533,7,0,0,0,0
451926,0,0,0,140775,0,go-server-deployment-56dd4c9fc7-9bnwf,140775,0,0,0,0,0
648678,0,0,0,543987,0,go-server-deployment-56dd4c9fc7-8mjp7,543987,0,0,0,0,0
0,0,0,0,182948,0,go-server-deployment-56dd4c9fc7-bgc96,182948,0,0,0,0,0
0,0,0,0,1133044,0,go-server-deployment-84ddfbc887-86n7n,1133044,0,0,0,0,0
4559,0,1,0,179828,1,go-server-deployment-56dd4c9fc7-b7lrm,179827,1,0,0,0,0
787240,0,1,0,1168843,1,go-server-deployment-84ddfbc887-6brcj,1168842,1,0,0,0,0
249562,0,0,0,355150,0,go-server-deployment-84ddfbc887-mlb4h,355150,0,0,0,0,0
0,0,7,0,94822,7,go-server-deployment-56dd4c9fc7-xn2fw,94815,7,0,0,0,0
304799,0,0,0,174914,0,go-server-deployment-56dd4c9fc7-jxckq,174914,0,0,0,0,0
0,0,0,0,374523,0,go-server-deployment-56dd4c9fc7-8wprt,374523,0,0,0,0,0
293946,0,6,0,227351,6,go-server-deployment-56dd4c9fc7-t9mkg,227345,6,0,0,0,0
0,0,0,0,188302,0,go-server-deployment-84ddfbc887-9h6vj,188302,0,0,0,0,0
0,0,1,0,330271,1,go-server-deployment-56dd4c9fc7-jfs4t,330270,1,0,0,0,0
0,0,0,0,1373271,0,go-server-deployment-84ddfbc887-q2r6w,1373271,0,0,0,0,0
300142,0,8,0,215471,8,go-server-deployment-56dd4c9fc7-qbv2l,215463,8,0,0,0,0
190911,0,0,0,749302,0,go-server-deployment-56dd4c9fc7-rpb4g,749302,0,0,0,0,0
0,0,0,0,485690,0,go-server-deployment-56dd4c9fc7-29jhg,485690,0,0,0,0,0
818443,0,1,0,288007,1,go-server-deployment-84ddfbc887-kvpvv,288006,1,0,0,0,0
314005,0,1,0,553485,1,go-server-deployment-56dd4c9fc7-ztwrl,553484,1,0,0,0,0
602031,0,10,0,88916,10,go-server-deployment-56dd4c9fc7-k92d8,88906,10,0,0,0,0
0,0,0,0,425018,0,go-server-deployment-84ddfbc887-xsrg5,425018,0,0,0,0,0
0,0,0,0,241433,0,go-server-deployment-84ddfbc887-ggjvg,241433,0,0,0,0,0
638364,0,4,0,302885,4,go-server-deployment-84ddfbc887-86hms,302881,4,0,0,0,0
2558993,0,25,0,645933,25,go-server-deployment-56dd4c9fc7-8hbxd,645908,25,0,0,0,0
0,0,0,0,682620,0,go-server-deployment-56dd4c9fc7-vfmnn,682620,0,0,0,0,0
178817,0,0,0,280318,0,go-server-deployment-56dd4c9fc7-8lchc,280318,0,0,0,0,0
2405875,0,0,0,723486,0,go-server-deployment-84ddfbc887-hzn6t,723486,0,0,0,0,0
0,0,0,0,1356243,0,go-server-deployment-84ddfbc887-bztft,1356243,0,0,0,0,0
0,0,0,0,675345,0,go-server-deployment-56dd4c9fc7-zq7mc,675345,0,0,0,0,0
1059056,0,1,0,737503,1,go-server-deployment-84ddfbc887-g5h77,737502,1,0,0,0,0
220172,0,5,0,679120,5,go-server-deployment-56dd4c9fc7-ktsk4,679115,5,0,0,0,0
0,0,0,0,579417,0,go-server-deployment-84ddfbc887-d5z8r,579417,0,0,0,0,0
351416,0,3,0,373040,3,go-server-deployment-84ddfbc887-zngtv,373037,3,0,0,0,0
1138383,0,7,0,354809,7,go-server-deployment-84ddfbc887-kwgxg,354802,7,0,0,0,0
1777597,0,0,0,783197,0,go-server-deployment-84ddfbc887-cwg9z,783197,0,0,0,0,0
12163,0,3,0,155442,3,go-server-deployment-56dd4c9fc7-m9525,155439,3,0,0,0,0
2489,0,16,0,81577,16,go-server-deployment-56dd4c9fc7-m6w5v,81561,16,0,0,0,0
571793,0,6,0,227114,6,go-server-deployment-56dd4c9fc7-7t827,227108,6,0,0,0,0
323375,0,3,0,167114,3,go-server-deployment-56dd4c9fc7-brd5l,167111,3,0,0,0,0
691496,0,3,0,518983,3,go-server-deployment-56dd4c9fc7-nr4b9,518980,3,0,0,0,0
0,0,2,0,134328,2,go-server-deployment-56dd4c9fc7-kbtd9,134326,2,0,0,0,0
1099651,0,46,0,159771,46,go-server-deployment-56dd4c9fc7-q2ccd,159725,46,0,0,0,0
816284,0,0,0,162771,0,go-server-deployment-56dd4c9fc7-p799z,162771,0,0,0,0,0
401655,0,1,0,348910,1,go-server-deployment-84ddfbc887-fd9kc,348909,1,0,0,0,0
248109,0,0,0,307078,0,go-server-deployment-56dd4c9fc7-6ht6n,307078,0,0,0,0,0
216428,0,1,0,330977,1,go-server-deployment-56dd4c9fc7-g8b8l,330976,1,0,0,0,0
449272,0,0,0,364005,0,go-server-deployment-84ddfbc887-9jjb5,364005,0,0,0,0,0
617050,0,19,0,246979,19,go-server-deployment-56dd4c9fc7-pvtmd,246960,19,0,0,0,0
900062,0,0,0,729716,0,go-server-deployment-84ddfbc887-8mgth,729716,0,0,0,0,0
80874,0,0,0,185577,0,go-server-deployment-56dd4c9fc7-2t7cf,185577,0,0,0,0,0
263919,0,4,0,633278,4,go-server-deployment-84ddfbc887-vgd9l,633274,4,0,0,0,0
0,0,0,0,109455,0,go-server-deployment-56dd4c9fc7-wchxc,109455,0,0,0,0,0
0,0,0,0,151139,0,go-server-deployment-56dd4c9fc7-zvcn6,151139,0,0,0,0,0
0,0,0,0,137142,0,go-server-deployment-56dd4c9fc7-9wp6t,137142,0,0,0,0,0
0,0,0,0,326046,0,go-server-deployment-84ddfbc887-99hjj,326046,0,0,0,0,0
1213199,0,1,0,857171,1,go-server-deployment-84ddfbc887-cb2dv,857170,1,0,0,0,0
113586,0,1,0,294410,1,go-server-deployment-56dd4c9fc7-bxpq7,294409,1,0,0,0,0
0,0,0,0,352275,0,go-server-deployment-84ddfbc887-n57dx,352275,0,0,0,0,0
675488,0,0,0,240021,0,go-server-deployment-84ddfbc887-n84g9,240021,0,0,0,0,0
0,0,0,0,487481,0,go-server-deployment-84ddfbc887-kk8mf,487481,0,0,0,0,0
1726,0,1,0,326883,1,go-server-deployment-56dd4c9fc7-dfczn,326882,1,0,0,0,0
0,0,0,0,660202,0,go-server-deployment-84ddfbc887-z6wkk,660202,0,0,0,0,0
1960705,0,4,0,386612,4,go-server-deployment-84ddfbc887-zm5jl,386608,4,0,0,0,0
1048742,0,0,0,580857,0,go-server-deployment-84ddfbc887-2csls,580857,0,0,0,0,0
1085468,0,6,0,104027,6,go-server-deployment-56dd4c9fc7-t7sdd,104021,6,0,0,0,0
77525,0,0,0,230219,0,go-server-deployment-56dd4c9fc7-kqgr7,230219,0,0,0,0,0
65219,0,1,0,455444,1,go-server-deployment-84ddfbc887-4dtpd,455443,1,0,0,0,0
16174,0,6,0,435804,6,go-server-deployment-56dd4c9fc7-t5dth,435798,6,0,0,0,0
160113,0,4,0,187727,4,go-server-deployment-56dd4c9fc7-6t6gv,187723,4,0,0,0,0
767276,0,3,0,201274,3,go-server-deployment-84ddfbc887-7cgv8,201271,3,0,0,0,0
503793,0,0,0,402612,0,go-server-deployment-84ddfbc887-6lsth,402612,0,0,0,0,0
734581,0,16,0,271160,16,go-server-deployment-56dd4c9fc7-mmgp7,271144,16,0,0,0,0
419299,0,0,0,644804,0,go-server-deployment-84ddfbc887-4xv8b,644804,0,0,0,0,0
32646,0,1,0,614797,1,go-server-deployment-84ddfbc887-mlw2b,614796,1,0,0,0,0
1984435,0,0,0,621800,0,go-server-deployment-84ddfbc887-5r7tz,621800,0,0,0,0,0
0,0,0,0,578484,0,go-server-deployment-84ddfbc887-v5z5j,578484,0,0,0,0,0
0,0,0,0,424722,0,go-server-deployment-56dd4c9fc7-rkpmf,424722,0,0,0,0,0
0,0,1,0,173773,1,go-server-deployment-56dd4c9fc7-fsgtv,173772,1,0,0,0,0
0,0,0,0,847096,0,go-server-deployment-84ddfbc887-zp2qr,847096,0,0,0,0,0
0,0,0,0,458190,0,go-server-deployment-56dd4c9fc7-rqgcl,458190,0,0,0,0,0
0,0,0,0,482762,0,go-server-deployment-56dd4c9fc7-pgvc7,482762,0,0,0,0,0
152785,0,1,0,314789,1,go-server-deployment-56dd4c9fc7-k8hnm,314788,1,0,0,0,0
304573,0,1,0,1170867,1,go-server-deployment-84ddfbc887-48zg5,1170866,1,0,0,0,0
285487,0,0,0,311156,0,go-server-deployment-84ddfbc887-cm62l,311156,0,0,0,0,0
283421,0,5,0,312515,5,go-server-deployment-56dd4c9fc7-2svq7,312510,5,0,0,0,0
0,0,0,0,239914,0,go-server-deployment-56dd4c9fc7-sntlr,239914,0,0,0,0,0
1959886,0,0,0,499364,0,go-server-deployment-84ddfbc887-7qhnn,499364,0,0,0,0,0
338169,0,0,0,288333,0,go-server-deployment-84ddfbc887-mxg7m,288333,0,0,0,0,0
1034254,0,2,0,235794,2,go-server-deployment-84ddfbc887-gs9qh,235792,2,0,0,0,0
258656,0,0,0,295332,1,go-server-deployment-56dd4c9fc7-bpkbv,295331,1,0,0,0,0
915958,0,1,0,333763,1,go-server-deployment-84ddfbc887-bqn2p,333762,1,0,0,0,0
1159,0,0,0,444239,0,go-server-deployment-84ddfbc887-nxdjm,444239,0,0,0,0,0
0,0,0,0,847858,0,go-server-deployment-56dd4c9fc7-khfsj,847858,0,0,0,0,0
652392,0,0,0,173756,0,go-server-deployment-84ddfbc887-rwwgt,173756,0,0,0,0,0
196917,0,0,0,1590270,0,go-server-deployment-84ddfbc887-95qj9,1590270,0,0,0,0,0
0,0,0,0,301833,0,go-server-deployment-84ddfbc887-jkbzh,301833,0,0,0,0,0
697643,0,2,0,513768,2,go-server-deployment-56dd4c9fc7-vljzr,513766,2,0,0,0,0
613764,0,1,0,270120,1,go-server-deployment-84ddfbc887-5j22m,270119,1,0,0,0,0
0,0,2,0,614191,3,go-server-deployment-56dd4c9fc7-cn6jt,614188,3,0,0,0,0
1192861,0,7,0,621387,7,go-server-deployment-84ddfbc887-676fk,621380,7,0,0,0,0
814052,0,26,0,398240,26,go-server-deployment-56dd4c9fc7-nc4jn,398214,26,0,0,0,0
0,0,1,0,797805,1,go-server-deployment-84ddfbc887-9dwpp,797804,1,0,0,0,0
864842,0,3,0,140026,4,go-server-deployment-84ddfbc887-nfz9r,140022,4,0,0,0,0
404213,0,0,0,231073,0,go-server-deployment-56dd4c9fc7-whftk,231073,0,0,0,0,0
285578,0,0,0,355360,0,go-server-deployment-84ddfbc887-4zrms,355360,0,0,0,0,0
2820,0,0,0,127124,0,go-server-deployment-56dd4c9fc7-2c28m,127124,0,0,0,0,0
463904,0,2,0,696800,2,go-server-deployment-56dd4c9fc7-7cd5w,696798,2,0,0,0,0
0,0,0,0,623012,0,go-server-deployment-56dd4c9fc7-lm9dv,623012,0,0,0,0,0
0,0,1,0,700021,1,go-server-deployment-84ddfbc887-vp2hf,700020,1,0,0,0,0
829745,0,0,0,406732,0,go-server-deployment-56dd4c9fc7-rf4t2,406732,0,0,0,0,0
951848,0,40,0,153626,40,go-server-deployment-56dd4c9fc7-8x7m2,153586,40,0,0,0,0
31078,0,7,0,688007,7,go-server-deployment-56dd4c9fc7-544sv,688000,7,0,0,0,0
1794147,0,0,0,706584,0,go-server-deployment-84ddfbc887-6d257,706584,0,0,0,0,0
0,0,0,0,445327,0,go-server-deployment-56dd4c9fc7-6kswk,445327,0,0,0,0,0
146861,0,0,0,709254,0,go-server-deployment-84ddfbc887-j867m,709254,0,0,0,0,0
0,0,0,0,369944,0,go-server-deployment-84ddfbc887-j6fm2,369944,0,0,0,0,0
0,0,0,0,305068,0,go-server-deployment-56dd4c9fc7-hpqxd,305068,0,0,0,0,0
1129351,0,0,0,652832,0,go-server-deployment-84ddfbc887-d4r5z,652832,0,0,0,0,0
0,0,2,0,773847,2,go-server-deployment-84ddfbc887-r5jmb,773845,2,0,0,0,0
1041230,0,2,0,1306428,2,go-server-deployment-56dd4c9fc7-gk8qg,1306426,2,0,0,0,0
466194,0,2,0,344169,2,go-server-deployment-84ddfbc887-nkwvb,344167,2,0,0,0,0
0,0,0,0,830470,0,go-server-deployment-84ddfbc887-vfc88,830470,0,0,0,0,0
223771,0,2,0,156459,2,go-server-deployment-56dd4c9fc7-zkfmz,156457,2,0,0,0,0
0,0,0,0,630670,0,go-server-deployment-84ddfbc887-f4sp4,630670,0,0,0,0,0
396736,0,2,0,283549,2,go-server-deployment-56dd4c9fc7-g7xrs,283547,2,0,0,0,0
0,0,0,0,263338,0,go-server-deployment-56dd4c9fc7-9tj5p,263338,0,0,0,0,0
0,0,0,0,252897,0,go-server-deployment-84ddfbc887-nljxj,252897,0,0,0,0,0
2734654,0,5,0,206903,5,go-server-deployment-56dd4c9fc7-ccp94,206898,5,0,0,0,0
0,0,0,0,315752,0,go-server-deployment-56dd4c9fc7-c7wjl,315752,0,0,0,0,0
0,0,1,0,177802,1,go-server-deployment-56dd4c9fc7-j2sn6,177801,1,0,0,0,0
1114597,0,12,0,694680,12,go-server-deployment-56dd4c9fc7-87vp9,694668,12,0,0,0,0
0,0,0,0,462307,0,go-server-deployment-56dd4c9fc7-dcrld,462307,0,0,0,0,0
777818,0,3,0,277035,3,go-server-deployment-84ddfbc887-5v64k,277032,3,0,0,0,0
0,0,0,0,621354,0,go-server-deployment-84ddfbc887-bhw47,621354,0,0,0,0,0
0,0,0,0,415705,0,go-server-deployment-84ddfbc887-2f98t,415705,0,0,0,0,0
0,0,0,0,590996,0,go-server-deployment-56dd4c9fc7-sprdv,590996,0,0,0,0,0
566781,0,2,0,335971,2,go-server-deployment-84ddfbc887-k9xmj,335969,2,0,0,0,0
235600,0,7,0,211764,7,go-server-deployment-56dd4c9fc7-tfznc,211757,7,0,0,0,0
3410,0,0,0,1154896,0,go-server-deployment-84ddfbc887-8lck8,1154896,0,0,0,0,0
0,0,0,0,388550,0,go-server-deployment-84ddfbc887-xt8rb,388550,0,0,0,0,0
11355,0,1,0,366256,1,go-server-deployment-84ddfbc887-96wk8,366255,1,0,0,0,0
153667,0,2,0,386544,2,go-server-deployment-84ddfbc887-krg6c,386542,2,0,0,0,0
0,0,0,0,377286,0,go-server-deployment-56dd4c9fc7-v8l9k,377286,0,0,0,0,0
1568952,0,5,0,665221,5,go-server-deployment-84ddfbc887-2dpl6,665216,5,0,0,0,0
309357,0,1,0,321559,1,go-server-deployment-56dd4c9fc7-pzjmw,321558,1,0,0,0,0
1829,0,4,0,554587,4,go-server-deployment-56dd4c9fc7-xjxd4,554583,4,0,0,0,0
410716,0,0,0,952112,0,go-server-deployment-84ddfbc887-68hbl,952112,0,0,0,0,0
664908,0,0,0,247787,0,go-server-deployment-56dd4c9fc7-mh9zd,247787,0,0,0,0,0
226776,0,0,0,223141,0,go-server-deployment-56dd4c9fc7-2fl9m,223141,0,0,0,0,0
597281,0,1,0,783054,1,go-server-deployment-84ddfbc887-hmswn,783053,1,0,0,0,0
1562882,0,0,0,590811,0,go-server-deployment-84ddfbc887-zc699,590811,0,0,0,0,0
1284609,0,6,0,457949,6,go-server-deployment-56dd4c9fc7-xr8sd,457943,6,0,0,0,0
400943,0,2,0,419636,2,go-server-deployment-84ddfbc887-w92qv,419634,2,0,0,0,0
434923,0,1,0,338872,1,go-server-deployment-84ddfbc887-w82hs,338871,1,0,0,0,0
1499231,0,0,0,297052,0,go-server-deployment-84ddfbc887-6b7x5,297052,0,0,0,0,0
155670,0,0,0,465330,0,go-server-deployment-56dd4c9fc7-lpjvc,465330,0,0,0,0,0
7400,0,0,0,398661,0,go-server-deployment-56dd4c9fc7-8sdlj,398661,0,0,0,0,0
35257,0,0,0,861322,0,go-server-deployment-84ddfbc887-djlmn,861322,0,0,0,0,0
0,0,0,0,1024142,0,go-server-deployment-84ddfbc887-l24gb,1024142,0,0,0,0,0
423233,0,1,0,493891,2,go-server-deployment-84ddfbc887-582xr,493889,2,0,0,0,0
0,0,0,0,1251052,0,go-server-deployment-84ddfbc887-59pgj,1251052,0,0,0,0,0
638250,0,1,0,562866,1,go-server-deployment-84ddfbc887-trmf4,562865,1,0,0,0,0
0,0,0,0,539352,0,go-server-deployment-56dd4c9fc7-dmwbb,539352,0,0,0,0,0
677218,0,0,0,466216,0,go-server-deployment-56dd4c9fc7-2kq6q,466216,0,0,0,0,0
262401,0,0,0,321489,0,go-server-deployment-56dd4c9fc7-59wwf,321489,0,0,0,0,0
2456,0,2,0,421378,2,go-server-deployment-84ddfbc887-xt9tb,421376,2,0,0,0,0
1952,0,0,0,615331,0,go-server-deployment-84ddfbc887-4tdrl,615331,0,0,0,0,0
697948,0,3,0,547039,3,go-server-deployment-84ddfbc887-h44gp,547036,3,0,0,0,0
0,0,0,0,201071,0,go-server-deployment-56dd4c9fc7-5n58m,201071,0,0,0,0,0
1301742,0,0,0,311952,0,go-server-deployment-84ddfbc887-qq8nd,311952,0,0,0,0,0
499879,0,0,0,394614,0,go-server-deployment-84ddfbc887-zkh6f,394614,0,0,0,0,0
0,0,0,0,300108,0,go-server-deployment-84ddfbc887-slbk7,300108,0,0,0,0,0
83350,0,0,0,331881,0,go-server-deployment-56dd4c9fc7-688bj,331881,0,0,0,0,0
1721401,0,3,0,614818,3,go-server-deployment-56dd4c9fc7-fbl96,614815,3,0,0,0,0
571488,0,2,0,177836,2,go-server-deployment-84ddfbc887-rv2gv,177834,2,0,0,0,0
382723,0,0,0,130199,0,go-server-deployment-56dd4c9fc7-wltgr,130199,0,0,0,0,0
1336,0,0,0,785993,0,go-server-deployment-84ddfbc887-tgd6j,785993,0,0,0,0,0
65754,0,1,0,240833,1,go-server-deployment-84ddfbc887-27c2z,240832,1,0,0,0,0
903765,0,0,0,371445,0,go-server-deployment-84ddfbc887-dt58v,371445,0,0,0,0,0
566140,0,0,0,546729,0,go-server-deployment-84ddfbc887-r9qh5,546729,0,0,0,0,0
0,0,0,0,276723,0,go-server-deployment-84ddfbc887-td9j9,276723,0,0,0,0,0
8106,0,0,0,563764,0,go-server-deployment-56dd4c9fc7-w9jdw,563764,0,0,0,0,0
0,0,1,0,98933,1,go-server-deployment-56dd4c9fc7-tqgzv,98932,1,0,0,0,0
1940900,0,0,0,635803,0,go-server-deployment-84ddfbc887-2zqml,635803,0,0,0,0,0
331653,0,9,0,241502,9,go-server-deployment-56dd4c9fc7-5mmdk,241493,9,0,0,0,0
0,0,4,0,499632,4,go-server-deployment-84ddfbc887-4smxd,499628,4,0,0,0,0
498748,0,0,0,237992,0,go-server-deployment-84ddfbc887-67q2c,237992,0,0,0,0,0
3394149,0,1,0,348635,1,go-server-deployment-84ddfbc887-dxhbt,348634,1,0,0,0,0
7,0,1,0,775334,1,go-server-deployment-84ddfbc887-kzpwx,775333,1,0,0,0,0
293868,0,0,0,264503,0,go-server-deployment-56dd4c9fc7-hnhg2,264503,0,0,0,0,0
0,0,0,0,258098,0,go-server-deployment-84ddfbc887-jl42x,258098,0,0,0,0,0
981202,0,3,0,403764,3,go-server-deployment-56dd4c9fc7-wgr26,403761,3,0,0,0,0
0,0,0,0,349430,0,go-server-deployment-84ddfbc887-jfd2p,349430,0,0,0,0,0
50983,0,0,0,234575,0,go-server-deployment-84ddfbc887-bvsv8,234575,0,0,0,0,0
410660,0,1,0,252765,1,go-server-deployment-84ddfbc887-4rz5b,252764,1,0,0,0,0
407697,0,0,0,355791,0,go-server-deployment-84ddfbc887-knlf4,355791,0,0,0,0,0
0,0,0,0,465117,0,go-server-deployment-56dd4c9fc7-2tk87,465117,0,0,0,0,0
1913871,0,64,0,527893,64,go-server-deployment-56dd4c9fc7-ffcp8,527829,64,0,0,0,0
0,0,2,0,578348,2,go-server-deployment-84ddfbc887-jm9sm,578346,2,0,0,0,0
83850,0,0,0,210062,0,go-server-deployment-56dd4c9fc7-x95b6,210062,0,0,0,0,0
506537,0,0,0,234973,0,go-server-deployment-84ddfbc887-d4792,234973,0,0,0,0,0
0,0,1,0,808269,1,go-server-deployment-56dd4c9fc7-6fw5h,808268,1,0,0,0,0
364057,0,1,0,185062,1,go-server-deployment-56dd4c9fc7-brsc6,185061,1,0,0,0,0
2245505,0,2,0,301250,2,go-server-deployment-84ddfbc887-4jsj4,301248,2,0,0,0,0
104810,0,0,0,192597,0,go-server-deployment-84ddfbc887-m2mr6,192597,0,0,0,0,0
2793939,0,64,0,345551,64,go-server-deployment-56dd4c9fc7-lkjtx,345487,64,0,0,0,0
0,0,1,0,157554,1,go-server-deployment-56dd4c9fc7-bwtsc,157553,1,0,0,0,0
1145185,0,14,0,403773,14,go-server-deployment-56dd4c9fc7-j7pdc,403759,14,0,0,0,0
0,0,0,0,533910,0,go-server-deployment-56dd4c9fc7-smmrh,533910,0,0,0,0,0
670778,0,0,0,220782,0,go-server-deployment-84ddfbc887-mjnp8,220782,0,0,0,0,0
491806,0,0,0,670332,0,go-server-deployment-56dd4c9fc7-625l8,670332,0,0,0,0,0
434444,0,0,0,329880,0,go-server-deployment-84ddfbc887-lbbt7,329880,0,0,0,0,0
966142,0,2,0,489202,2,go-server-deployment-56dd4c9fc7-47pjc,489200,2,0,0,0,0
1062215,0,0,0,1082744,0,go-server-deployment-84ddfbc887-qn97m,1082744,0,0,0,0,0
0,0,0,0,208601,0,go-server-deployment-56dd4c9fc7-9dtvd,208601,0,0,0,0,0
1694025,0,0,0,270320,1,go-server-deployment-84ddfbc887-c89r8,270319,1,0,0,0,0
18460,0,0,0,564891,0,go-server-deployment-56dd4c9fc7-4t6p6,564891,0,0,0,0,0
216406,0,2,0,412976,2,go-server-deployment-56dd4c9fc7-d9vng,412974,2,0,0,0,0
397281,0,0,0,203225,0,go-server-deployment-84ddfbc887-448lb,203225,0,0,0,0,0
0,0,0,0,368931,0,go-server-deployment-84ddfbc887-vqm8r,368931,0,0,0,0,0
255254,0,0,0,509081,0,go-server-deployment-84ddfbc887-bnjsz,509081,0,0,0,0,0
0,0,1,0,810154,1,go-server-deployment-84ddfbc887-jbflj,810153,1,0,0,0,0
0,0,1,0,349024,1,go-server-deployment-56dd4c9fc7-k6vnd,349023,1,0,0,0,0
878670,0,0,0,369642,0,go-server-deployment-56dd4c9fc7-rsflk,369642,0,0,0,0,0
76444,0,1,0,611789,1,go-server-deployment-84ddfbc887-7xvql,611788,1,0,0,0,0
2537179,0,1,0,958446,1,go-server-deployment-84ddfbc887-w7pcp,958445,1,0,0,0,0
596602,0,1,0,974507,1,go-server-deployment-84ddfbc887-fkxq9,974506,1,0,0,0,0
530892,0,0,0,318817,0,go-server-deployment-84ddfbc887-55zwc,318817,0,0,0,0,0
0,0,0,0,295590,0,go-server-deployment-56dd4c9fc7-45jt9,295590,0,0,0,0,0
6498,0,3,0,420371,3,go-server-deployment-84ddfbc887-8tmdz,420368,3,0,0,0,0
994560,0,4,0,217379,4,go-server-deployment-84ddfbc887-9rzxj,217375,4,0,0,0,0
0,0,0,0,355301,0,go-server-deployment-84ddfbc887-k75ks,355301,0,0,0,0,0
0,0,0,0,243813,0,go-server-deployment-56dd4c9fc7-hf2gk,243813,0,0,0,0,0
0,0,1,0,152854,1,go-server-deployment-56dd4c9fc7-wqnx5,152853,1,0,0,0,0
253164,0,0,0,190324,0,go-server-deployment-56dd4c9fc7-9fx6d,190324,0,0,0,0,0
0,0,0,0,421405,0,go-server-deployment-56dd4c9fc7-bscgx,421405,0,0,0,0,0
0,0,0,0,151432,0,go-server-deployment-56dd4c9fc7-qcpg2,151432,0,0,0,0,0
0,0,1,0,737017,1,go-server-deployment-84ddfbc887-hhbdf,737016,1,0,0,0,0
681690,0,1,0,161495,2,go-server-deployment-56dd4c9fc7-sw522,161493,2,0,0,0,0
1614307,0,7,0,609151,7,go-server-deployment-56dd4c9fc7-wzxcb,609144,7,0,0,0,0
0,0,0,0,242271,0,go-server-deployment-56dd4c9fc7-rnhzd,242271,0,0,0,0,0
0,0,1,0,195166,1,go-server-deployment-84ddfbc887-fqp7k,195165,1,0,0,0,0
464035,0,12,0,206801,12,go-server-deployment-56dd4c9fc7-2dvpf,206789,12,0,0,0,0
258835,0,1,0,247813,1,go-server-deployment-56dd4c9fc7-tnsl7,247812,1,0,0,0,0
329205,0,3,0,323610,3,go-server-deployment-56dd4c9fc7-mz95l,323607,3,0,0,0,0
2227520,0,2,0,618472,2,go-server-deployment-84ddfbc887-48d57,618470,2,0,0,0,0
1353887,0,1,0,180075,1,go-server-deployment-84ddfbc887-bsfrs,180074,1,0,0,0,0
0,0,1,0,691179,1,go-server-deployment-84ddfbc887-pxkzn,691178,1,0,0,0,0
0,0,1,0,358172,1,go-server-deployment-56dd4c9fc7-wpj9b,358171,1,0,0,0,0
1631463,0,5,0,341592,5,go-server-deployment-56dd4c9fc7-xj9mw,341587,5,0,0,0,0
0,0,1,0,570443,1,go-server-deployment-84ddfbc887-v49mq,570442,1,0,0,0,0
585591,0,3,0,93579,3,go-server-deployment-56dd4c9fc7-k7rd8,93576,3,0,0,0,0
984431,0,0,0,375632,0,go-server-deployment-84ddfbc887-qz28t,375632,0,0,0,0,0
692312,0,9,0,81467,9,go-server-deployment-56dd4c9fc7-x956z,81458,9,0,0,0,0
0,0,4,0,180482,4,go-server-deployment-56dd4c9fc7-m4s4t,180478,4,0,0,0,0
1565822,0,0,0,282132,0,go-server-deployment-84ddfbc887-g95d2,282132,0,0,0,0,0
0,0,2,0,395451,2,go-server-deployment-56dd4c9fc7-fpnwf,395449,2,0,0,0,0
405378,0,1,0,250962,1,go-server-deployment-84ddfbc887-lknrf,250961,1,0,0,0,0
0,0,3,0,221105,3,go-server-deployment-56dd4c9fc7-c9nvz,221102,3,0,0,0,0
0,0,0,0,677826,0,go-server-deployment-84ddfbc887-j5lml,677826,0,0,0,0,0
1188991,0,0,0,202616,0,go-server-deployment-84ddfbc887-lhtll,202616,0,0,0,0,0
0,0,0,0,609136,1,go-server-deployment-56dd4c9fc7-8cqpm,609135,1,0,0,0,0
406306,0,6,0,548542,6,go-server-deployment-56dd4c9fc7-xsmpz,548536,6,0,0,0,0
0,0,7,0,234807,7,go-server-deployment-56dd4c9fc7-5mzfh,234800,7,0,0,0,0
0,0,4,0,332767,4,go-server-deployment-56dd4c9fc7-g5z2t,332763,4,0,0,0,0
801158,0,0,0,288284,0,go-server-deployment-84ddfbc887-kwm9b,288284,0,0,0,0,0
509560,0,0,0,262201,0,go-server-deployment-84ddfbc887-tbm6g,262201,0,0,0,0,0
571075,0,1,0,538999,1,go-server-deployment-84ddfbc887-sjbrd,538998,1,0,0,0,0
5504,0,2,0,483666,2,go-server-deployment-56dd4c9fc7-rkkgd,483664,2,0,0,0,0
293807,0,0,0,521765,0,go-server-deployment-56dd4c9fc7-qtkzp,521765,0,0,0,0,0
0,0,0,0,1215368,0,go-server-deployment-84ddfbc887-2pvfj,1215368,0,0,0,0,0
141813,0,3,0,258957,3,go-server-deployment-56dd4c9fc7-9cs5s,258954,3,0,0,0,0
54958,0,1,0,166645,1,go-server-deployment-56dd4c9fc7-66v5n,166644,1,0,0,0,0
284040,0,5,0,317657,5,go-server-deployment-56dd4c9fc7-2q7cf,317652,5,0,0,0,0
2093883,0,2,0,183787,2,go-server-deployment-84ddfbc887-xg8jt,183785,2,0,0,0,0
0,0,0,0,1032103,0,go-server-deployment-84ddfbc887-mlcvt,1032103,0,0,0,0,0
0,0,0,0,972086,0,go-server-deployment-84ddfbc887-wmk77,972086,0,0,0,0,0
0,0,0,0,798991,0,go-server-deployment-84ddfbc887-q8szc,798991,0,0,0,0,0
857232,0,10,0,397298,10,go-server-deployment-56dd4c9fc7-js9kw,397288,10,0,0,0,0
3692,0,4,0,308648,4,go-server-deployment-56dd4c9fc7-lckvx,308644,4,0,0,0,0
640240,0,0,0,294988,0,go-server-deployment-84ddfbc887-kqpjj,294988,0,0,0,0,0
711717,0,0,0,403436,0,go-server-deployment-84ddfbc887-pvz9m,403436,0,0,0,0,0
0,0,0,0,449432,0,go-server-deployment-56dd4c9fc7-rwgbl,449432,0,0,0,0,0
0,0,0,0,937379,0,go-server-deployment-84ddfbc887-rv76z,937379,0,0,0,0,0
890271,0,13,0,158163,13,go-server-deployment-56dd4c9fc7-q2tcx,158150,13,0,0,0,0
375096,0,0,0,214622,0,go-server-deployment-56dd4c9fc7-rd6f5,214622,0,0,0,0,0
133281,0,0,0,806488,0,go-server-deployment-84ddfbc887-6rtl4,806488,0,0,0,0,0
756898,0,1,0,173486,1,go-server-deployment-84ddfbc887-s2qxc,173485,1,0,0,0,0
13269,0,0,0,352083,0,go-server-deployment-84ddfbc887-st84j,352083,0,0,0,0,0
1274,0,0,0,557940,0,go-server-deployment-84ddfbc887-fh7hq,557940,0,0,0,0,0
990720,0,1,0,246622,2,go-server-deployment-84ddfbc887-smsl8,246620,2,0,0,0,0
0,0,0,0,449485,0,go-server-deployment-56dd4c9fc7-tsxw2,449485,0,0,0,0,0
0,0,18,0,477886,18,go-server-deployment-56dd4c9fc7-b2fjm,477868,18,0,0,0,0
420064,0,0,0,117335,0,go-server-deployment-56dd4c9fc7-ldgv8,117335,0,0,0,0,0
140742,0,2,0,250748,2,go-server-deployment-56dd4c9fc7-q4gd4,250746,2,0,0,0,0
483381,0,0,0,581504,0,go-server-deployment-84ddfbc887-s7mmg,581504,0,0,0,0,0
0,0,0,0,300319,0,go-server-deployment-84ddfbc887-mtprb,300319,0,0,0,0,0
277681,0,29,0,236514,29,go-server-deployment-56dd4c9fc7-zkwd5,236485,29,0,0,0,0
600691,0,0,0,144659,0,go-server-deployment-56dd4c9fc7-59m9s,144659,0,0,0,0,0
455660,0,1,0,495870,1,go-server-deployment-84ddfbc887-s656g,495869,1,0,0,0,0
0,0,0,0,288995,0,go-server-deployment-84ddfbc887-mmk8g,288995,0,0,0,0,0
1729507,0,0,0,561027,0,go-server-deployment-84ddfbc887-p8glj,561027,0,0,0,0,0
1624419,0,12,0,1407450,12,go-server-deployment-56dd4c9fc7-6hd7l,1407438,12,0,0,0,0
0,0,1,0,182188,1,go-server-deployment-56dd4c9fc7-lkfnv,182187,1,0,0,0,0
816953,0,0,0,658542,0,go-server-deployment-84ddfbc887-j77rw,658542,0,0,0,0,0
294663,0,0,0,88841,0,go-server-deployment-56dd4c9fc7-xfrkd,88841,0,0,0,0,0
0,0,0,0,371813,0,go-server-deployment-56dd4c9fc7-hqtw5,371813,0,0,0,0,0
0,0,0,0,213566,1,go-server-deployment-56dd4c9fc7-hwm7n,213565,1,0,0,0,0
0,0,0,0,1007593,0,go-server-deployment-84ddfbc887-tvbnk,1007593,0,0,0,0,0
0,0,1,0,588987,1,go-server-deployment-56dd4c9fc7-8whcs,588986,1,0,0,0,0
0,0,0,0,542623,0,go-server-deployment-56dd4c9fc7-nc2hh,542623,0,0,0,0,0
0,0,0,0,256308,0,go-server-deployment-56dd4c9fc7-sslbn,256308,0,0,0,0,0
770614,0,0,0,389805,0,go-server-deployment-84ddfbc887-mt8xw,389805,0,0,0,0,0
0,0,0,0,786798,0,go-server-deployment-84ddfbc887-76pfn,786798,0,0,0,0,0
0,0,3,0,908385,3,go-server-deployment-56dd4c9fc7-795cw,908382,3,0,0,0,0
594419,0,1,0,465023,1,go-server-deployment-84ddfbc887-c8dh4,465022,1,0,0,0,0
453969,0,0,0,110464,0,go-server-deployment-56dd4c9fc7-rnggk,110464,0,0,0,0,0
0,0,0,0,583506,0,go-server-deployment-56dd4c9fc7-h5q9j,583506,0,0,0,0,0
296827,0,0,0,352587,0,go-server-deployment-84ddfbc887-7thx7,352587,0,0,0,0,0
371054,0,0,0,549414,0,go-server-deployment-56dd4c9fc7-zd9nm,549414,0,0,0,0,0
0,0,0,0,827947,0,go-server-deployment-84ddfbc887-wmmk8,827947,0,0,0,0,0
471788,0,4,0,299236,4,go-server-deployment-84ddfbc887-dx4bm,299232,4,0,0,0,0
0,0,0,0,463977,0,go-server-deployment-84ddfbc887-nfjc4,463977,0,0,0,0,0
2,0,0,0,284801,0,go-server-deployment-84ddfbc887-6prch,284801,0,0,0,0,0
213988,0,0,0,233647,0,go-server-deployment-56dd4c9fc7-ndkmc,233647,0,0,0,0,0
373983,0,1,0,1189176,1,go-server-deployment-84ddfbc887-svr9m,1189175,1,0,0,0,0
758350,0,0,0,267081,0,go-server-deployment-84ddfbc887-bznmx,267081,0,0,0,0,0
1296109,0,5,0,445406,5,go-server-deployment-56dd4c9fc7-j8jzc,445401,5,0,0,0,0
1878732,0,1,0,437797,1,go-server-deployment-84ddfbc887-mzpg5,437796,1,0,0,0,0
370470,0,4,0,144378,4,go-server-deployment-56dd4c9fc7-k49qg,144374,4,0,0,0,0
0,0,1,0,330088,1,go-server-deployment-56dd4c9fc7-hh696,330087,1,0,0,0,0
0,0,0,0,383526,0,go-server-deployment-56dd4c9fc7-smbs7,383526,0,0,0,0,0
1154212,0,6,0,433974,6,go-server-deployment-56dd4c9fc7-9pg5z,433968,6,0,0,0,0
0,0,2,0,536414,2,go-server-deployment-56dd4c9fc7-zcmfn,536412,2,0,0,0,0
0,0,1,0,485523,1,go-server-deployment-84ddfbc887-q82jh,485522,1,0,0,0,0
295951,0,6,0,310978,6,go-server-deployment-56dd4c9fc7-bms2b,310972,6,0,0,0,0
1813249,0,1,0,389185,1,go-server-deployment-84ddfbc887-9v2mq,389184,1,0,0,0,0
0,0,0,0,817056,0,go-server-deployment-84ddfbc887-ddbq4,817056,0,0,0,0,0
17625,0,0,0,1133563,0,go-server-deployment-84ddfbc887-lprbs,1133563,0,0,0,0,0
226886,0,8,0,452220,8,go-server-deployment-56dd4c9fc7-m9j2f,452212,8,0,0,0,0
1849561,0,104,0,750885,104,go-server-deployment-56dd4c9fc7-zsdbv,750781,104,0,0,0,0
198513,0,1,0,836033,1,go-server-deployment-84ddfbc887-rcprl,836032,1,0,0,0,0
169359,0,10,0,309904,10,go-server-deployment-56dd4c9fc7-6zm2c,309894,10,0,0,0,0
0,0,2,0,653099,2,go-server-deployment-56dd4c9fc7-zfvm5,653097,2,0,0,0,0
0,0,2,0,489260,2,go-server-deployment-84ddfbc887-gvqm2,489258,2,0,0,0,0
470153,0,3,0,169239,3,go-server-deployment-56dd4c9fc7-wq8s5,169236,3,0,0,0,0
511361,0,0,0,343704,0,go-server-deployment-84ddfbc887-jv9d5,343704,0,0,0,0,0
0,0,0,0,209747,0,go-server-deployment-56dd4c9fc7-6lptk,209747,0,0,0,0,0
0,0,0,0,435299,0,go-server-deployment-84ddfbc887-6tjhn,435299,0,0,0,0,0
822756,0,10,0,869786,10,go-server-deployment-56dd4c9fc7-c8gts,869776,10,0,0,0,0
1181663,0,0,0,495467,0,go-server-deployment-56dd4c9fc7-7p6vb,495467,0,0,0,0,0
466770,0,3,0,430533,3,go-server-deployment-56dd4c9fc7-m8wm7,430530,3,0,0,0,0
0,0,0,0,514193,0,go-server-deployment-56dd4c9fc7-5l5r6,514193,0,0,0,0,0
921422,0,29,0,128650,29,go-server-deployment-56dd4c9fc7-ktspx,128621,29,0,0,0,0
692547,0,3,0,191019,4,go-server-deployment-84ddfbc887-xrnlt,191015,4,0,0,0,0
631605,0,0,0,551912,0,go-server-deployment-84ddfbc887-vqzq2,551912,0,0,0,0,0
0,0,3,0,267664,3,go-server-deployment-56dd4c9fc7-nbtwh,267661,3,0,0,0,0
1982826,0,0,0,357446,0,go-server-deployment-84ddfbc887-rnf7j,357446,0,0,0,0,0
1189713,0,7,0,580593,7,go-server-deployment-56dd4c9fc7-4hgch,580586,7,0,0,0,0
2300418,0,2,0,158046,2,go-server-deployment-84ddfbc887-hsvwk,158044,2,0,0,0,0
486682,0,1,0,483524,1,go-server-deployment-56dd4c9fc7-qncz7,483523,1,0,0,0,0
1020004,0,1,0,662303,1,go-server-deployment-84ddfbc887-gzxpc,662302,1,0,0,0,0
841832,0,3,0,411372,3,go-server-deployment-84ddfbc887-sc9qq,411369,3,0,0,0,0
1075248,0,3,0,176995,3,go-server-deployment-56dd4c9fc7-k869h,176992,3,0,0,0,0
0,0,2,0,715813,3,go-server-deployment-56dd4c9fc7-phvq2,715810,3,0,0,0,0
0,0,5,0,107694,5,go-server-deployment-56dd4c9fc7-t2nnt,107689,5,0,0,0,0
758089,0,3,0,239932,3,go-server-deployment-84ddfbc887-rfwtm,239929,3,0,0,0,0
532805,0,0,0,243953,0,go-server-deployment-56dd4c9fc7-8n6x5,243953,0,0,0,0,0
206380,0,0,0,207790,0,go-server-deployment-56dd4c9fc7-6tw52,207790,0,0,0,0,0
0,0,0,0,267123,0,go-server-deployment-56dd4c9fc7-j2vw6,267123,0,0,0,0,0
478347,0,2,0,178821,2,go-server-deployment-56dd4c9fc7-z64st,178819,2,0,0,0,0
0,0,0,0,1282842,0,go-server-deployment-84ddfbc887-98kbg,1282842,0,0,0,0,0
0,0,0,0,360000,0,go-server-deployment-84ddfbc887-vzllp,360000,0,0,0,0,0
0,0,0,0,939644,0,go-server-deployment-84ddfbc887-j89zx,939644,0,0,0,0,0
191498,0,0,0,635812,0,go-server-deployment-56dd4c9fc7-dngvv,635812,0,0,0,0,0
0,0,0,0,312665,0,go-server-deployment-56dd4c9fc7-k7s9f,312665,0,0,0,0,0
2184214,0,5,0,170323,5,go-server-deployment-56dd4c9fc7-vkvf8,170318,5,0,0,0,0
2115228,0,47,0,328675,47,go-server-deployment-56dd4c9fc7-82msx,328628,47,0,0,0,0
783185,0,0,0,249667,0,go-server-deployment-84ddfbc887-fvfqt,249667,0,0,0,0,0
1427622,0,0,0,104548,0,go-server-deployment-56dd4c9fc7-w4ldt,104548,0,0,0,0,0
0,0,4,0,385728,4,go-server-deployment-56dd4c9fc7-55bh4,385724,4,0,0,0,0
674641,0,0,0,580777,0,go-server-deployment-84ddfbc887-2wk2z,580777,0,0,0,0,0
0,0,0,0,216966,0,go-server-deployment-84ddfbc887-wtmmt,216966,0,0,0,0,0
0,0,0,0,148342,0,go-server-deployment-56dd4c9fc7-26596,148342,0,0,0,0,0
574082,0,2,0,621240,2,go-server-deployment-56dd4c9fc7-2rhnd,621238,2,0,0,0,0
389063,0,0,0,132461,0,go-server-deployment-56dd4c9fc7-58w6n,132461,0,0,0,0,0
1224658,0,0,0,103713,0,go-server-deployment-56dd4c9fc7-f59rc,103713,0,0,0,0,0
0,0,0,0,632746,0,go-server-deployment-56dd4c9fc7-g7h6t,632746,0,0,0,0,0
491884,0,0,0,285703,0,go-server-deployment-84ddfbc887-hn26b,285703,0,0,0,0,0
386728,0,0,0,467373,0,go-server-deployment-56dd4c9fc7-j2pms,467373,0,0,0,0,0
1823240,0,4,0,338751,4,go-server-deployment-84ddfbc887-8bj2n,338747,4,0,0,0,0
0,0,1,0,181694,1,go-server-deployment-56dd4c9fc7-x4dpt,181693,1,0,0,0,0
88448,0,0,0,333437,0,go-server-deployment-56dd4c9fc7-d7g96,333437,0,0,0,0,0
1188874,0,0,0,620897,0,go-server-deployment-84ddfbc887-cb78b,620897,0,0,0,0,0
2553453,0,0,0,677222,1,go-server-deployment-84ddfbc887-f9qkf,677221,1,0,0,0,0
125,0,0,0,770226,0,go-server-deployment-84ddfbc887-bxrcd,770226,0,0,0,0,0
8006,0,2,0,219384,2,go-server-deployment-56dd4c9fc7-f8p29,219382,2,0,0,0,0
0,0,0,0,348485,0,go-server-deployment-84ddfbc887-qk4w4,348485,0,0,0,0,0
3557,0,1,0,390011,1,go-server-deployment-56dd4c9fc7-gxzww,390010,1,0,0,0,0
152688,0,1,0,278306,1,go-server-deployment-56dd4c9fc7-gzbql,278305,1,0,0,0,0
1480062,0,1,0,363589,1,go-server-deployment-84ddfbc887-x6nx5,363588,1,0,0,0,0
32251,0,0,0,342790,1,go-server-deployment-84ddfbc887-4wb7p,342789,1,0,0,0,0
594012,0,1,0,942611,1,go-server-deployment-56dd4c9fc7-6qlr6,942610,1,0,0,0,0
1035819,0,2,0,380296,2,go-server-deployment-84ddfbc887-zcrhk,380294,2,0,0,0,0
109468,0,0,0,258365,0,go-server-deployment-56dd4c9fc7-wpq5q,258365,0,0,0,0,0
372830,0,2,0,332656,2,go-server-deployment-56dd4c9fc7-4mjjv,332654,2,0,0,0,0
0,0,0,0,605303,0,go-server-deployment-84ddfbc887-wdc5t,605303,0,0,0,0,0
58264,0,0,0,437734,0,go-server-deployment-84ddfbc887-h6462,437734,0,0,0,0,0
226446,0,4,0,249762,4,go-server-deployment-56dd4c9fc7-9hg5q,249758,4,0,0,0,0
506245,0,2,0,493133,2,go-server-deployment-56dd4c9fc7-kppq7,493131,2,0,0,0,0
0,0,0,0,435442,0,go-server-deployment-56dd4c9fc7-tsmkq,435442,0,0,0,0,0
0,0,1,0,254809,1,go-server-deployment-56dd4c9fc7-6z4lm,254808,1,0,0,0,0
771447,0,0,0,869386,0,go-server-deployment-84ddfbc887-ms9m9,869386,0,0,0,0,0
730,0,0,0,130202,0,go-server-deployment-56dd4c9fc7-rfnxv,130202,0,0,0,0,0
744467,0,0,0,719407,0,go-server-deployment-56dd4c9fc7-vrj6q,719407,0,0,0,0,0
252319,0,6,0,383422,6,go-server-deployment-84ddfbc887-zz2d4,383416,6,0,0,0,0
304311,0,0,0,662271,0,go-server-deployment-56dd4c9fc7-ktjl5,662271,0,0,0,0,0
466510,0,1,0,164436,1,go-server-deployment-56dd4c9fc7-jmtrf,164435,1,0,0,0,0
479568,0,0,0,223019,0,go-server-deployment-84ddfbc887-hwzw2,223019,0,0,0,0,0
0,0,0,0,942638,0,go-server-deployment-84ddfbc887-vbnvl,942638,0,0,0,0,0
238740,0,0,0,401232,0,go-server-deployment-84ddfbc887-rpwwk,401232,0,0,0,0,0
808925,0,0,0,402318,0,go-server-deployment-56dd4c9fc7-bxb56,402318,0,0,0,0,0
0,0,0,0,786287,0,go-server-deployment-84ddfbc887-bgfdd,786287,0,0,0,0,0
123546,0,4,0,987063,4,go-server-deployment-84ddfbc887-vfh8x,987059,4,0,0,0,0
931955,0,0,0,854845,0,go-server-deployment-84ddfbc887-8dfh2,854845,0,0,0,0,0
0,0,0,0,1048323,0,go-server-deployment-84ddfbc887-wmmrt,1048323,0,0,0,0,0
153651,0,0,0,134264,0,go-server-deployment-56dd4c9fc7-mgkgb,134264,0,0,0,0,0
0,0,1,0,311462,1,go-server-deployment-56dd4c9fc7-vfw4p,311461,1,0,0,0,0
530951,0,0,0,711824,0,go-server-deployment-84ddfbc887-5f7vw,711824,0,0,0,0,0
664836,0,0,0,563220,0,go-server-deployment-56dd4c9fc7-znjsq,563220,0,0,0,0,0
97699,0,0,0,276278,0,go-server-deployment-84ddfbc887-pxpgt,276278,0,0,0,0,0
108681,0,0,0,95094,0,go-server-deployment-56dd4c9fc7-g4r9g,95094,0,0,0,0,0
0,0,0,0,546791,0,go-server-deployment-84ddfbc887-wbfdm,546791,0,0,0,0,0
1888345,0,0,0,467362,0,go-server-deployment-84ddfbc887-47svr,467362,0,0,0,0,0
0,0,0,0,538406,0,go-server-deployment-56dd4c9fc7-pxb6m,538406,0,0,0,0,0
482275,0,0,0,259934,0,go-server-deployment-84ddfbc887-26rvr,259934,0,0,0,0,0
532317,0,1,0,277509,1,go-server-deployment-56dd4c9fc7-zwjdj,277508,1,0,0,0,0
1338888,0,10,0,439789,10,go-server-deployment-56dd4c9fc7-xt8mh,439779,10,0,0,0,0
522807,0,0,0,258537,0,go-server-deployment-84ddfbc887-q6m6n,258537,0,0,0,0,0
623258,0,1,0,278666,1,go-server-deployment-56dd4c9fc7-2qnc2,278665,1,0,0,0,0
981044,0,0,0,557249,0,go-server-deployment-84ddfbc887-tbdwv,557249,0,0,0,0,0
1196435,0,1,0,1041965,1,go-server-deployment-84ddfbc887-ffpvh,1041964,1,0,0,0,0
2519,0,0,0,455608,0,go-server-deployment-56dd4c9fc7-f6gpw,455608,0,0,0,0,0
1495783,0,1,0,455118,1,go-server-deployment-84ddfbc887-n8s7x,455117,1,0,0,0,0
0,0,0,0,242514,0,go-server-deployment-84ddfbc887-bkhtt,242514,0,0,0,0,0
9765,0,0,0,723039,0,go-server-deployment-84ddfbc887-5sv7j,723039,0,0,0,0,0
172714,0,0,0,571585,1,go-server-deployment-56dd4c9fc7-rx9dr,571584,1,0,0,0,0
0,0,0,0,225590,0,go-server-deployment-56dd4c9fc7-f9l8j,225590,0,0,0,0,0
111505,0,0,0,378801,0,go-server-deployment-84ddfbc887-ftdfh,378801,0,0,0,0,0
578099,0,0,0,540112,1,go-server-deployment-84ddfbc887-q27pk,540111,1,0,0,0,0
711300,0,5,0,497989,5,go-server-deployment-56dd4c9fc7-g2vrx,497984,5,0,0,0,0
17565,0,0,0,217495,0,go-server-deployment-84ddfbc887-9v8vs,217495,0,0,0,0,0
118398,0,0,0,220831,0,go-server-deployment-56dd4c9fc7-wr7pp,220831,0,0,0,0,0
12129,0,0,0,184913,0,go-server-deployment-56dd4c9fc7-kbkw9,184913,0,0,0,0,0
1375173,0,0,0,803152,0,go-server-deployment-84ddfbc887-kxfqh,803152,0,0,0,0,0
580037,0,10,0,202290,10,go-server-deployment-56dd4c9fc7-q87xl,202280,10,0,0,0,0
614850,0,3,0,220069,4,go-server-deployment-84ddfbc887-cg87c,220065,4,0,0,0,0
0,0,1,0,353891,1,go-server-deployment-84ddfbc887-4pmm7,353890,1,0,0,0,0
0,0,0,0,391021,0,go-server-deployment-56dd4c9fc7-bbtjx,391021,0,0,0,0,0
0,0,1,0,381049,1,go-server-deployment-84ddfbc887-j7bqh,381048,1,0,0,0,0
880492,0,0,0,395376,0,go-server-deployment-84ddfbc887-8gwrt,395376,0,0,0,0,0
0,0,0,0,282409,1,go-server-deployment-84ddfbc887-v6wlb,282408,1,0,0,0,0
181273,0,0,0,563717,0,go-server-deployment-84ddfbc887-xqtn4,563717,0,0,0,0,0
388607,0,6,0,434203,6,go-server-deployment-56dd4c9fc7-gdgkq,434197,6,0,0,0,0
639848,0,0,0,478592,0,go-server-deployment-84ddfbc887-4njcj,478592,0,0,0,0,0
583179,0,1,0,323700,1,go-server-deployment-84ddfbc887-dtgm7,323699,1,0,0,0,0
648821,0,0,0,193434,0,go-server-deployment-84ddfbc887-4vcjv,193434,0,0,0,0,0
2232368,0,2,0,765533,2,go-server-deployment-84ddfbc887-2f2hr,765531,2,0,0,0,0
50,0,6,0,153297,6,go-server-deployment-56dd4c9fc7-rsjwl,153291,6,0,0,0,0
336250,0,0,0,527232,0,go-server-deployment-84ddfbc887-49dfc,527232,0,0,0,0,0
1773845,0,0,0,367632,0,go-server-deployment-84ddfbc887-hmj2s,367632,0,0,0,0,0
0,0,0,0,722739,0,go-server-deployment-56dd4c9fc7-fk9v6,722739,0,0,0,0,0
1519792,0,16,0,201793,16,go-server-deployment-56dd4c9fc7-qtq94,201777,16,0,0,0,0
0,0,0,0,288242,0,go-server-deployment-84ddfbc887-qlll9,288242,0,0,0,0,0
175636,0,0,0,137327,0,go-server-deployment-56dd4c9fc7-r85bs,137327,0,0,0,0,0
1941155,0,0,0,626338,0,go-server-deployment-84ddfbc887-vjgvj,626338,0,0,0,0,0
477965,0,0,0,374341,0,go-server-deployment-84ddfbc887-tjsw9,374341,0,0,0,0,0
5637,0,0,0,654846,0,go-server-deployment-84ddfbc887-4f85h,654846,0,0,0,0,0
0,0,0,0,359626,0,go-server-deployment-56dd4c9fc7-q9vfn,359626,0,0,0,0,0
0,0,0,0,286135,0,go-server-deployment-84ddfbc887-d6rl6,286135,0,0,0,0,0
224032,0,6,0,310691,6,go-server-deployment-56dd4c9fc7-2zq2r,310685,6,0,0,0,0
1226538,0,3,0,219761,3,go-server-deployment-56dd4c9fc7-tmn8t,219758,3,0,0,0,0
321388,0,1,0,334950,1,go-server-deployment-84ddfbc887-fsl74,334949,1,0,0,0,0
37623,0,2,0,109696,2,go-server-deployment-56dd4c9fc7-2prq2,109694,2,0,0,0,0
0,0,0,0,1223380,0,go-server-deployment-84ddfbc887-qp74g,1223380,0,0,0,0,0
943449,0,37,0,393309,37,go-server-deployment-56dd4c9fc7-g8b7m,393272,37,0,0,0,0
0,0,0,0,181002,0,go-server-deployment-56dd4c9fc7-kl9rf,181002,0,0,0,0,0
0,0,1,0,246183,1,go-server-deployment-56dd4c9fc7-pkw68,246182,1,0,0,0,0
1819218,0,30,0,627709,30,go-server-deployment-56dd4c9fc7-6r44n,627679,30,0,0,0,0
244552,0,0,0,97753,0,go-server-deployment-56dd4c9fc7-p6sdl,97753,0,0,0,0,0
827,0,0,0,457984,0,go-server-deployment-56dd4c9fc7-fvvp4,457984,0,0,0,0,0
0,0,1,0,257484,1,go-server-deployment-56dd4c9fc7-x86kg,257483,1,0,0,0,0
0,0,1,0,460863,1,go-server-deployment-56dd4c9fc7-576dt,460862,1,0,0,0,0
21607,0,2,0,251671,2,go-server-deployment-56dd4c9fc7-crhbz,251669,2,0,0,0,0
5057,0,0,0,364782,0,go-server-deployment-56dd4c9fc7-4rdjj,364782,0,0,0,0,0
2614,0,0,0,456511,0,go-server-deployment-84ddfbc887-lhm8z,456511,0,0,0,0,0
0,0,1,0,1054319,1,go-server-deployment-84ddfbc887-lcnbs,1054318,1,0,0,0,0
239822,0,0,0,453676,0,go-server-deployment-84ddfbc887-4dhdh,453676,0,0,0,0,0
633474,0,1,0,359741,1,go-server-deployment-56dd4c9fc7-n2vkf,359740,1,0,0,0,0
385229,0,1,0,446954,1,go-server-deployment-84ddfbc887-p9hcj,446953,1,0,0,0,0
913591,0,0,0,383670,0,go-server-deployment-84ddfbc887-qwbgz,383670,0,0,0,0,0
239677,0,1,0,217772,1,go-server-deployment-56dd4c9fc7-h4f2g,217771,1,0,0,0,0
0,0,1,0,705744,1,go-server-deployment-84ddfbc887-xbpgv,705743,1,0,0,0,0
0,0,2,0,215907,2,go-server-deployment-56dd4c9fc7-bqht6,215905,2,0,0,0,0
913500,0,0,0,253481,0,go-server-deployment-84ddfbc887-mmzbg,253481,0,0,0,0,0
554238,0,0,0,544016,0,go-server-deployment-84ddfbc887-j682b,544016,0,0,0,0,0
319082,0,4,0,359558,4,go-server-deployment-56dd4c9fc7-m5f2j,359554,4,0,0,0,0
0,0,0,0,307238,0,go-server-deployment-56dd4c9fc7-949rc,307238,0,0,0,0,0
465561,0,0,0,486553,0,go-server-deployment-56dd4c9fc7-bkvnx,486553,0,0,0,0,0
87171,0,0,0,221369,0,go-server-deployment-56dd4c9fc7-49p8r,221369,0,0,0,0,0
10356,0,0,0,966224,0,go-server-deployment-84ddfbc887-4zd6b,966224,0,0,0,0,0
5894,0,1,0,658654,1,go-server-deployment-84ddfbc887-g7bhs,658653,1,0,0,0,0
926740,0,2,0,198962,2,go-server-deployment-84ddfbc887-dxmkl,198960,2,0,0,0,0
2026233,0,2,0,430203,2,go-server-deployment-84ddfbc887-f4g5q,430201,2,0,0,0,0
0,0,0,0,196627,0,go-server-deployment-56dd4c9fc7-swqv8,196627,0,0,0,0,0
37412,0,0,0,740050,0,go-server-deployment-84ddfbc887-rwsnc,740050,0,0,0,0,0
0,0,0,0,158869,0,go-server-deployment-56dd4c9fc7-lk77v,158869,0,0,0,0,0
8543,0,0,0,491315,0,go-server-deployment-84ddfbc887-9cpft,491315,0,0,0,0,0
0,0,1,0,802153,1,go-server-deployment-84ddfbc887-hnh4s,802152,1,0,0,0,0
958121,0,1,0,441444,1,go-server-deployment-84ddfbc887-th8cn,441443,1,0,0,0,0
313463,0,1,0,55032,1,go-server-deployment-56dd4c9fc7-2tz29,55031,1,0,0,0,0
0,0,0,0,1010082,0,go-server-deployment-84ddfbc887-7nvvp,1010082,0,0,0,0,0
23468,0,0,0,147936,0,go-server-deployment-56dd4c9fc7-5n2rq,147936,0,0,0,0,0
7908,0,1,0,668200,1,go-server-deployment-84ddfbc887-ksz8q,668199,1,0,0,0,0
451669,0,2,0,252041,2,go-server-deployment-56dd4c9fc7-jg8rd,252039,2,0,0,0,0
875020,0,1,0,323987,1,go-server-deployment-84ddfbc887-kqlmv,323986,1,0,0,0,0
12252,0,10,0,532677,10,go-server-deployment-56dd4c9fc7-ng5dx,532667,10,0,0,0,0
0,0,1,0,767534,1,go-server-deployment-56dd4c9fc7-nq7qb,767533,1,0,0,0,0
0,0,0,0,1323821,0,go-server-deployment-84ddfbc887-967d4,1323821,0,0,0,0,0
469052,0,0,0,457418,0,go-server-deployment-84ddfbc887-5hv9v,457418,0,0,0,0,0
0,0,0,0,411798,0,go-server-deployment-56dd4c9fc7-779wt,411798,0,0,0,0,0
1861327,0,19,0,408920,19,go-server-deployment-56dd4c9fc7-hszdj,408901,19,0,0,0,0
853870,0,0,0,279849,0,go-server-deployment-84ddfbc887-r5cw9,279849,0,0,0,0,0
0,0,1,0,600101,1,go-server-deployment-56dd4c9fc7-kr4wt,600100,1,0,0,0,0
0,0,0,0,487795,0,go-server-deployment-84ddfbc887-52vgs,487795,0,0,0,0,0
1186855,0,0,0,357835,0,go-server-deployment-84ddfbc887-fqdnh,357835,0,0,0,0,0
356031,0,0,0,219480,0,go-server-deployment-84ddfbc887-m7n4z,219480,0,0,0,0,0
0,0,0,0,625601,0,go-server-deployment-56dd4c9fc7-ckqkf,625601,0,0,0,0,0
583121,0,1,0,289194,1,go-server-deployment-84ddfbc887-khfrw,289193,1,0,0,0,0
0,0,0,0,302097,0,go-server-deployment-56dd4c9fc7-j2r59,302097,0,0,0,0,0
16597,0,1,0,71091,1,go-server-deployment-56dd4c9fc7-ds8n8,71090,1,0,0,0,0
632274,0,0,0,894042,0,go-server-deployment-84ddfbc887-2nrww,894042,0,0,0,0,0
428393,0,0,0,326159,0,go-server-deployment-84ddfbc887-8qrkm,326159,0,0,0,0,0
0,0,0,0,314533,0,go-server-deployment-56dd4c9fc7-qlgbn,314533,0,0,0,0,0
0,0,4,0,448204,4,go-server-deployment-56dd4c9fc7-m49rs,448200,4,0,0,0,0
840554,0,1,0,265486,1,go-server-deployment-84ddfbc887-fcd2c,265485,1,0,0,0,0
298084,0,0,0,173365,0,go-server-deployment-56dd4c9fc7-xwxl4,173365,0,0,0,0,0
875013,0,0,0,367129,0,go-server-deployment-84ddfbc887-54cdc,367129,0,0,0,0,0
1916967,0,0,0,300440,0,go-server-deployment-84ddfbc887-l5d5b,300440,0,0,0,0,0
355495,0,6,0,336007,6,go-server-deployment-84ddfbc887-pn6q8,336001,6,0,0,0,0
0,0,0,0,251962,0,go-server-deployment-56dd4c9fc7-rd4r8,251962,0,0,0,0,0
8235,0,0,0,290345,0,go-server-deployment-56dd4c9fc7-6xx9n,290345,0,0,0,0,0
0,0,0,0,177879,0,go-server-deployment-56dd4c9fc7-mfd6c,177879,0,0,0,0,0
701784,0,4,0,98422,4,go-server-deployment-56dd4c9fc7-j86z7,98418,4,0,0,0,0
96185,0,1,0,857546,1,go-server-deployment-84ddfbc887-pgtpt,857545,1,0,0,0,0
0,0,0,0,639700,0,go-server-deployment-84ddfbc887-mk5n8,639700,0,0,0,0,0
46308,0,0,0,522534,0,go-server-deployment-84ddfbc887-5fbll,522534,0,0,0,0,0
536686,0,0,0,120857,0,go-server-deployment-56dd4c9fc7-v7mxc,120857,0,0,0,0,0
498073,0,4,0,579884,4,go-server-deployment-56dd4c9fc7-z6g75,579880,4,0,0,0,0
1221347,0,1,0,355403,1,go-server-deployment-84ddfbc887-4fzz7,355402,1,0,0,0,0
0,0,1,0,516482,1,go-server-deployment-56dd4c9fc7-lbtc5,516481,1,0,0,0,0
71670,0,0,0,532894,0,go-server-deployment-84ddfbc887-4c6f5,532894,0,0,0,0,0
1074056,0,1,0,267115,1,go-server-deployment-56dd4c9fc7-6bpmc,267114,1,0,0,0,0
771213,0,7,0,208781,7,go-server-deployment-56dd4c9fc7-q8hrv,208774,7,0,0,0,0
300764,0,0,0,1001613,0,go-server-deployment-84ddfbc887-4xgd7,1001613,0,0,0,0,0
0,0,0,0,241393,0,go-server-deployment-84ddfbc887-dcwdk,241393,0,0,0,0,0
0,0,0,0,415323,0,go-server-deployment-56dd4c9fc7-m4tk7,415323,0,0,0,0,0
6510,0,0,0,178999,0,go-server-deployment-56dd4c9fc7-9qh48,178999,0,0,0,0,0
390589,0,4,0,205903,4,go-server-deployment-56dd4c9fc7-r6x6k,205899,4,0,0,0,0
607545,0,0,0,242492,1,go-server-deployment-84ddfbc887-dxhhj,242491,1,0,0,0,0
0,0,0,0,572277,0,go-server-deployment-56dd4c9fc7-ms2c7,572277,0,0,0,0,0
0,0,2,0,150618,2,go-server-deployment-56dd4c9fc7-84nbr,150616,2,0,0,0,0
112801,0,0,0,229412,0,go-server-deployment-56dd4c9fc7-wbs7b,229412,0,0,0,0,0
299343,0,4,0,290179,4,go-server-deployment-84ddfbc887-2wl94,290175,4,0,0,0,0
671077,0,0,0,148911,0,go-server-deployment-84ddfbc887-h5df8,148911,0,0,0,0,0
0,0,0,0,600118,0,go-server-deployment-56dd4c9fc7-x2hzr,600118,0,0,0,0,0
270345,0,0,0,247296,0,go-server-deployment-56dd4c9fc7-f98d4,247296,0,0,0,0,0
490761,0,1,0,920720,1,go-server-deployment-84ddfbc887-bcs6b,920719,1,0,0,0,0
863,0,0,0,488370,0,go-server-deployment-84ddfbc887-6rd5h,488370,0,0,0,0,0
304217,0,2,0,138154,2,go-server-deployment-56dd4c9fc7-r6st8,138152,2,0,0,0,0
1125365,0,1,0,82512,1,go-server-deployment-56dd4c9fc7-5fpph,82511,1,0,0,0,0
0,0,0,0,359449,0,go-server-deployment-56dd4c9fc7-52kj6,359449,0,0,0,0,0
698567,0,2,0,300931,2,go-server-deployment-84ddfbc887-smpng,300929,2,0,0,0,0
994270,0,1,0,449134,1,go-server-deployment-84ddfbc887-9cw89,449133,1,0,0,0,0
326,0,1,0,206080,1,go-server-deployment-56dd4c9fc7-pkv9m,206079,1,0,0,0,0
694751,0,1,0,534399,1,go-server-deployment-84ddfbc887-6dp6b,534398,1,0,0,0,0
237399,0,0,0,722057,0,go-server-deployment-56dd4c9fc7-nj698,722057,0,0,0,0,0
16372,0,0,0,272717,0,go-server-deployment-84ddfbc887-bsmqj,272717,0,0,0,0,0
453773,0,3,0,504983,3,go-server-deployment-56dd4c9fc7-t68l4,504980,3,0,0,0,0
727903,0,32,0,206968,32,go-server-deployment-56dd4c9fc7-qrsfg,206936,32,0,0,0,0
160309,0,1,0,175227,1,go-server-deployment-56dd4c9fc7-stt82,175226,1,0,0,0,0
1034701,0,0,0,372509,0,go-server-deployment-84ddfbc887-9j4m7,372509,0,0,0,0,0
300942,0,0,0,53975,0,go-server-deployment-56dd4c9fc7-cz7nv,53975,0,0,0,0,0
484385,0,2,0,650480,2,go-server-deployment-84ddfbc887-dk222,650478,2,0,0,0,0
619811,0,4,0,288590,4,go-server-deployment-84ddfbc887-vjgff,288586,4,0,0,0,0
3628,0,0,0,314587,0,go-server-deployment-84ddfbc887-nksms,314587,0,0,0,0,0
1739,0,0,0,744456,0,go-server-deployment-56dd4c9fc7-zthgf,744456,0,0,0,0,0
842007,0,7,0,694770,7,go-server-deployment-56dd4c9fc7-pqcpv,694763,7,0,0,0,0
2480719,0,0,0,333800,0,go-server-deployment-84ddfbc887-qfq5z,333800,0,0,0,0,0
2031806,0,2,0,809929,2,go-server-deployment-84ddfbc887-dwnfx,809927,2,0,0,0,0
766529,0,1,0,198506,1,go-server-deployment-84ddfbc887-7jc7n,198505,1,0,0,0,0
0,0,0,0,286825,0,go-server-deployment-56dd4c9fc7-6j2j4,286825,0,0,0,0,0
0,0,0,0,192222,0,go-server-deployment-56dd4c9fc7-ljc2b,192222,0,0,0,0,0
342764,0,1,0,583841,1,go-server-deployment-56dd4c9fc7-vbc8r,583840,1,0,0,0,0
405926,0,0,0,136179,0,go-server-deployment-56dd4c9fc7-m8ftx,136179,0,0,0,0,0
93346,0,2,0,510719,2,go-server-deployment-84ddfbc887-fqtd4,510717,2,0,0,0,0
554536,0,2,0,188045,2,go-server-deployment-84ddfbc887-mvdzf,188043,2,0,0,0,0
1661184,0,0,0,165938,0,go-server-deployment-56dd4c9fc7-d7mk6,165938,0,0,0,0,0
0,0,0,0,148729,0,go-server-deployment-56dd4c9fc7-tfrtq,148729,0,0,0,0,0
0,0,1,0,243110,1,go-server-deployment-84ddfbc887-w42t9,243109,1,0,0,0,0
292785,0,1,0,421301,1,go-server-deployment-84ddfbc887-xgf2l,421300,1,0,0,0,0
696522,0,0,0,190896,1,go-server-deployment-84ddfbc887-kl8kz,190895,1,0,0,0,0
972155,0,7,0,134398,7,go-server-deployment-56dd4c9fc7-v7nz9,134391,7,0,0,0,0
0,0,0,0,284280,0,go-server-deployment-84ddfbc887-qdmqd,284280,0,0,0,0,0
900048,0,1,0,430642,1,go-server-deployment-84ddfbc887-f8tbm,430641,1,0,0,0,0
815497,0,0,0,634658,0,go-server-deployment-84ddfbc887-flkbx,634658,0,0,0,0,0
686058,0,0,0,211388,0,go-server-deployment-84ddfbc887-rxm8z,211388,0,0,0,0,0
587548,0,1,0,304283,1,go-server-deployment-56dd4c9fc7-f2km4,304282,1,0,0,0,0
525882,0,0,0,232537,0,go-server-deployment-84ddfbc887-ffmv4,232537,0,0,0,0,0
0,0,0,0,189582,0,go-server-deployment-56dd4c9fc7-6r4k4,189582,0,0,0,0,0
1986601,0,1,0,511725,1,go-server-deployment-84ddfbc887-r774g,511724,1,0,0,0,0
0,0,0,0,1122806,0,go-server-deployment-84ddfbc887-44fr6,1122806,0,0,0,0,0
3462,0,0,0,248129,0,go-server-deployment-84ddfbc887-9gqb2,248129,0,0,0,0,0
334901,0,3,0,182743,3,go-server-deployment-56dd4c9fc7-2smrr,182740,3,0,0,0,0
0,0,0,0,881907,0,go-server-deployment-84ddfbc887-gn8pv,881907,0,0,0,0,0
501011,0,0,0,871295,0,go-server-deployment-84ddfbc887-nctlq,871295,0,0,0,0,0
0,0,0,0,326161,0,go-server-deployment-56dd4c9fc7-48wpj,326161,0,0,0,0,0
0,0,0,0,506570,0,go-server-deployment-56dd4c9fc7-vvmgs,506570,0,0,0,0,0
533323,0,3,0,102775,3,go-server-deployment-56dd4c9fc7-fz2f7,102772,3,0,0,0,0
217351,0,2,0,552248,2,go-server-deployment-84ddfbc887-j9xt7,552246,2,0,0,0,0
86243,0,1,0,354499,1,go-server-deployment-84ddfbc887-g9sn7,354498,1,0,0,0,0
610114,0,1,0,258759,1,go-server-deployment-56dd4c9fc7-bgcln,258758,1,0,0,0,0
582684,0,2,0,178233,2,go-server-deployment-56dd4c9fc7-zwph6,178231,2,0,0,0,0
217193,0,3,0,1122346,3,go-server-deployment-84ddfbc887-kd4nz,1122343,3,0,0,0,0
1001218,0,2,0,535510,2,go-server-deployment-84ddfbc887-gwg7f,535508,2,0,0,0,0
2224816,0,5,0,201079,5,go-server-deployment-56dd4c9fc7-4qt44,201074,5,0,0,0,0
349683,0,1,0,353172,1,go-server-deployment-56dd4c9fc7-95kvx,353171,1,0,0,0,0
200,0,0,0,499850,0,go-server-deployment-56dd4c9fc7-stnnk,499850,0,0,0,0,0
5788,0,0,0,809694,0,go-server-deployment-84ddfbc887-wttzr,809694,0,0,0,0,0
0,0,0,0,203520,0,go-server-deployment-84ddfbc887-4tz5x,203520,0,0,0,0,0
1070861,0,0,0,514089,0,go-server-deployment-56dd4c9fc7-bd87v,514089,0,0,0,0,0
1054609,0,0,0,916210,0,go-server-deployment-84ddfbc887-qlvn4,916210,0,0,0,0,0
0,0,0,0,1010482,0,go-server-deployment-84ddfbc887-6rkgj,1010482,0,0,0,0,0
919469,0,2,0,1003479,2,go-server-deployment-84ddfbc887-t6rlc,1003477,2,0,0,0,0
556680,0,1,0,181587,2,go-server-deployment-56dd4c9fc7-4x6xg,181585,2,0,0,0,0
499094,0,2,0,155200,2,go-server-deployment-56dd4c9fc7-w5g5j,155198,2,0,0,0,0
0,0,0,0,295094,0,go-server-deployment-84ddfbc887-lj99j,295094,0,0,0,0,0
0,0,1,0,353509,1,go-server-deployment-56dd4c9fc7-lnx4g,353508,1,0,0,0,0
1922316,0,15,0,380552,15,go-server-deployment-56dd4c9fc7-gmxxr,380537,15,0,0,0,0
0,0,0,0,340199,0,go-server-deployment-56dd4c9fc7-vbb9b,340199,0,0,0,0,0
691335,0,0,0,508579,0,go-server-deployment-56dd4c9fc7-q9mth,508579,0,0,0,0,0
0,0,0,0,313663,0,go-server-deployment-84ddfbc887-r6prs,313663,0,0,0,0,0
0,0,2,0,278603,2,go-server-deployment-56dd4c9fc7-sg7g5,278601,2,0,0,0,0
0,0,1,0,343437,1,go-server-deployment-84ddfbc887-jz8fv,343436,1,0,0,0,0
0,0,1,0,330687,1,go-server-deployment-84ddfbc887-scppj,330686,1,0,0,0,0
0,0,2,0,296983,2,go-server-deployment-56dd4c9fc7-2c8lv,296981,2,0,0,0,0
0,0,0,0,61743,0,go-server-deployment-56dd4c9fc7-zkdld,61743,0,0,0,0,0
646043,0,3,0,349819,3,go-server-deployment-84ddfbc887-rtl8l,349816,3,0,0,0,0
977107,0,2,0,460388,2,go-server-deployment-84ddfbc887-dxv7r,460386,2,0,0,0,0
0,0,0,0,760770,0,go-server-deployment-84ddfbc887-k4c8m,760770,0,0,0,0,0
265124,0,0,0,413741,0,go-server-deployment-84ddfbc887-qchxk,413741,0,0,0,0,0
0,0,1,0,701815,1,go-server-deployment-84ddfbc887-6wkcl,701814,1,0,0,0,0
689152,0,0,0,1040860,0,go-server-deployment-84ddfbc887-wbzqd,1040860,0,0,0,0,0
0,0,0,0,704962,0,go-server-deployment-84ddfbc887-f64qj,704962,0,0,0,0,0
1337626,0,1,0,840314,1,go-server-deployment-84ddfbc887-6z9k6,840313,1,0,0,0,0
1571880,0,2,0,431673,2,go-server-deployment-84ddfbc887-89kpb,431671,2,0,0,0,0
1346,0,0,0,442840,0,go-server-deployment-84ddfbc887-86ph8,442840,0,0,0,0,0
0,0,1,0,332620,1,go-server-deployment-56dd4c9fc7-jmxct,332619,1,0,0,0,0
1048702,0,33,0,125801,33,go-server-deployment-56dd4c9fc7-lmsnz,125768,33,0,0,0,0
66429,0,0,0,547613,0,go-server-deployment-56dd4c9fc7-ngsbq,547613,0,0,0,0,0
0,0,0,0,321099,0,go-server-deployment-84ddfbc887-d777s,321099,0,0,0,0,0
1851445,0,1,0,337855,1,go-server-deployment-84ddfbc887-rfgn8,337854,1,0,0,0,0
1289676,0,0,0,720492,0,go-server-deployment-84ddfbc887-m4wn7,720492,0,0,0,0,0
0,0,0,0,309543,0,go-server-deployment-84ddfbc887-rpjjg,309543,0,0,0,0,0
226558,0,2,0,617456,2,go-server-deployment-84ddfbc887-jlxxl,617454,2,0,0,0,0
1136779,0,0,0,456247,0,go-server-deployment-84ddfbc887-v7k6p,456247,0,0,0,0,0
5559,0,0,0,731790,0,go-server-deployment-84ddfbc887-rw94c,731790,0,0,0,0,0
120304,0,1,0,226060,1,go-server-deployment-84ddfbc887-jrnsg,226059,1,0,0,0,0
559108,0,0,0,565249,0,go-server-deployment-56dd4c9fc7-2nz2r,565249,0,0,0,0,0
586866,0,1,0,256934,1,go-server-deployment-84ddfbc887-5tb7h,256933,1,0,0,0,0
1000880,0,1,0,202674,1,go-server-deployment-56dd4c9fc7-4dgsw,202673,1,0,0,0,0
0,0,0,0,228197,0,go-server-deployment-56dd4c9fc7-qfnnc,228197,0,0,0,0,0
108952,0,0,0,868868,0,go-server-deployment-84ddfbc887-qd97n,868868,0,0,0,0,0
478725,0,1,0,538503,1,go-server-deployment-84ddfbc887-mq4mv,538502,1,0,0,0,0
0,0,0,0,748980,0,go-server-deployment-84ddfbc887-45qhw,748980,0,0,0,0,0
512983,0,1,0,135916,1,go-server-deployment-56dd4c9fc7-qpvbk,135915,1,0,0,0,0
518145,0,1,0,547415,1,go-server-deployment-56dd4c9fc7-vgmsd,547414,1,0,0,0,0
416830,0,0,0,1173211,0,go-server-deployment-84ddfbc887-tx4h9,1173211,0,0,0,0,0
0,0,0,0,799870,0,go-server-deployment-84ddfbc887-f9m8v,799870,0,0,0,0,0
0,0,0,0,302016,0,go-server-deployment-56dd4c9fc7-g8x9n,302016,0,0,0,0,0
0,0,0,0,642828,0,go-server-deployment-84ddfbc887-5rpqx,642828,0,0,0,0,0
0,0,0,0,292174,0,go-server-deployment-56dd4c9fc7-ps6n2,292174,0,0,0,0,0
242604,0,0,0,98778,0,go-server-deployment-56dd4c9fc7-9td5v,98778,0,0,0,0,0
662998,0,0,0,664267,0,go-server-deployment-84ddfbc887-vfv55,664267,0,0,0,0,0
607355,0,1,0,179331,1,go-server-deployment-56dd4c9fc7-z2g84,179330,1,0,0,0,0
304025,0,1,0,244959,1,go-server-deployment-56dd4c9fc7-dtxbt,244958,1,0,0,0,0
1184792,0,1,0,336879,1,go-server-deployment-84ddfbc887-mm5v7,336878,1,0,0,0,0
0,0,0,0,670402,0,go-server-deployment-84ddfbc887-sc7cl,670402,0,0,0,0,0
8692,0,1,0,240415,1,go-server-deployment-56dd4c9fc7-cd4qb,240414,1,0,0,0,0
200,0,0,0,335093,0,go-server-deployment-56dd4c9fc7-n6fsb,335093,0,0,0,0,0
1512281,0,14,0,241493,14,go-server-deployment-56dd4c9fc7-wr84l,241479,14,0,0,0,0
0,0,1,0,348074,1,go-server-deployment-56dd4c9fc7-fk7m8,348073,1,0,0,0,0
240779,0,1,0,261288,1,go-server-deployment-84ddfbc887-kg66k,261287,1,0,0,0,0
262075,0,1,0,198285,1,go-server-deployment-56dd4c9fc7-hg79n,198284,1,0,0,0,0
612484,0,1,0,177072,1,go-server-deployment-56dd4c9fc7-47m6s,177071,1,0,0,0,0
1090071,0,0,0,451737,1,go-server-deployment-84ddfbc887-c7kht,451736,1,0,0,0,0